20x20.bmp 250:24
283 283 283 283 283 283 283 283 283 283 164 165 165 165 165 165 165 165 165 165 165 165 165 165 165 165 165 165 165 165 165 165 165 165 165 165 166 282 283 283 283 283 164 166 283 283 282 283 283 283 283 283 283 283 282 283 283 283 283 140 140 140 283 207 309 283 283 283 284 283 283 283 283 284 283 164 165 166 283 284 251 51 51 51 51 51 51 51 253 282 283 283 283 283 283 283 283 283 283 283 283 283 282 283 283 283 164 165 165 165 165 165 165 165 165 165 165 165 166 333 283 207 309 283 283 283 283 283 283 283 283 283 283 283 322 283 283 283 283 283 322 283 283 283 283 283 283 283 283 283 283 333 283 283 283 283 283 283 283 283 283 283 148 152 174 174 174 174 174 174 174 174 174 174 174 174 174 174 175 283 283 283 283 283 283 283 283 160 49 49 49 49 49 49 49 45 40 40 40 40 40 40 40 40 40 40 40 47 49 49 49 49 158 283 283 283 283 251 34 34 34 34 34 34 34 34 34 34 34 34 34 34 34 5 80 31 31 31 31 31 31 31 31 31 31 31 31 31 31 31 
283 283 283 283 139 141 283 139 141 283 164 165 165 165 165 165 165 165 165 165 165 165 165 165 165 165 165 165 165 165 165 165 165 165 165 165 166 307 308 232 283 283 189 191 283 283 307 232 283 283 283 140 141 283 307 232 283 283 164 165 165 165 166 284 283 283 283 159 284 283 159 283 283 284 283 164 165 166 283 284 251 51 51 51 51 51 51 51 253 282 283 139 141 283 283 283 283 334 283 283 283 283 307 232 283 334 283 240 165 165 165 165 165 165 165 165 241 190 191 283 207 309 283 283 283 283 283 283 283 333 283 139 140 140 140 140 140 140 140 140 140 140 140 140 141 283 283 321 283 283 283 283 283 283 283 283 322 283 283 283 283 148 152 174 174 174 174 174 174 174 174 174 174 174 174 174 174 174 175 283 283 283 283 283 283 320 283 160 49 49 49 49 49 49 49 70 121 40 40 40 40 40 40 40 40 40 122 72 49 49 49 133 209 283 283 226 227 176 34 34 34 34 34 34 34 34 34 34 34 34 34 34 5 80 31 31 31 31 31 31 31 31 31 31 31 31 31 31 31 31 
283 283 321 283 164 166 283 189 191 283 164 165 165 165 165 165 165 165 165 165 165 165 165 165 165 165 165 165 165 165 165 165 165 165 165 241 191 283 283 282 283 283 283 283 159 283 283 307 232 283 164 165 216 141 283 307 232 283 164 165 165 165 166 284 283 283 283 283 284 283 283 283 283 284 283 164 165 166 283 284 251 51 51 51 51 51 51 51 253 282 283 189 191 283 283 283 283 283 283 283 283 283 283 307 232 283 283 189 190 190 240 165 165 165 241 190 191 283 283 207 309 283 283 283 283 139 141 283 283 283 139 215 165 165 165 165 165 165 165 165 165 165 165 165 216 140 140 140 140 141 283 283 283 283 333 283 283 333 283 283 148 152 174 174 174 174 174 174 174 174 174 174 174 174 174 174 174 174 175 283 283 283 283 283 283 283 283 160 49 49 49 49 49 49 49 49 70 121 40 40 40 40 40 122 71 71 72 49 49 133 134 209 283 226 227 176 34 34 34 34 34 34 34 34 34 34 34 34 34 34 5 6 80 31 31 31 31 31 31 31 31 31 31 31 31 31 31 31 31 2 
283 283 283 283 189 191 283 283 283 283 189 240 165 165 165 165 165 165 165 165 165 165 165 165 165 165 165 165 165 165 165 165 165 165 165 166 283 283 283 282 283 283 283 283 283 283 283 283 282 283 164 165 165 216 141 283 282 283 164 165 165 241 191 284 283 283 140 141 284 139 141 283 207 309 283 215 165 166 283 284 251 51 51 51 51 51 51 202 278 282 283 283 283 283 283 283 283 283 283 283 322 283 283 283 307 232 283 283 333 283 189 190 190 190 191 283 283 207 308 309 283 283 283 321 139 215 216 141 283 139 215 165 165 165 165 165 165 165 165 165 165 165 165 165 165 165 165 165 165 216 140 140 140 141 283 283 283 283 283 148 152 174 174 174 174 174 174 174 174 174 174 174 174 174 174 174 174 126 200 283 283 283 283 334 283 283 283 160 49 49 49 49 49 49 49 49 49 70 71 71 71 71 71 72 49 49 49 49 49 158 283 283 226 176 34 34 34 34 34 34 34 34 34 34 34 34 34 34 34 5 80 31 31 31 31 31 31 31 31 31 31 31 31 31 31 31 31 31 2 78 
283 283 283 283 283 283 283 322 283 283 283 189 240 165 165 165 165 165 165 165 165 165 165 165 165 165 165 165 165 165 165 165 165 165 241 191 283 283 283 307 232 283 283 140 140 140 141 283 282 283 164 165 165 165 166 283 282 283 189 190 190 191 283 284 283 164 165 166 284 189 191 283 284 283 164 165 241 191 207 309 251 51 51 51 51 51 51 253 257 233 283 283 283 333 283 139 140 141 283 283 283 283 283 283 283 307 308 232 283 283 283 334 283 283 283 283 207 309 283 283 283 283 283 283 189 240 241 191 283 164 165 165 165 165 165 165 165 165 165 165 165 165 165 165 165 165 165 165 165 165 165 165 165 216 141 283 321 283 283 173 174 174 174 174 174 174 174 174 174 174 174 174 174 174 174 174 174 175 283 283 283 283 283 283 283 283 283 210 135 49 49 49 49 49 49 49 49 49 49 49 49 49 49 49 49 49 49 49 133 209 283 283 251 34 34 34 34 34 34 34 34 34 34 34 34 34 34 34 5 80 31 31 31 31 31 31 31 31 31 31 31 31 31 31 31 31 31 2 78 28 
141 283 283 283 283 283 283 283 283 283 283 283 189 240 165 165 165 165 165 165 165 165 165 165 165 165 165 165 165 165 165 165 165 241 191 283 283 283 283 283 282 283 164 165 165 165 166 283 282 283 164 165 165 165 166 283 282 283 283 283 283 283 283 284 283 215 165 166 284 283 283 283 284 283 164 165 166 283 284 226 176 51 51 51 51 51 202 278 282 283 283 283 283 283 283 189 190 191 283 283 139 140 141 283 283 283 283 307 308 232 283 283 283 207 308 308 309 283 283 283 283 334 283 283 283 189 191 283 283 164 165 165 165 165 165 165 165 165 165 165 165 165 165 165 165 165 165 165 165 165 165 165 165 165 166 283 283 283 283 173 174 174 174 174 174 174 174 174 174 174 126 199 199 199 199 199 199 200 283 283 322 283 333 283 283 283 283 283 210 134 135 49 49 49 49 49 49 49 49 49 49 49 49 49 49 133 134 134 209 283 283 226 176 34 34 34 34 34 34 34 5 6 7 34 34 34 34 34 30 31 31 31 31 31 31 31 31 31 31 31 31 31 31 31 31 31 2 78 28 28 
216 141 283 283 283 139 141 283 283 320 283 283 283 189 240 165 165 165 165 165 165 165 165 165 165 165 165 165 165 165 165 241 190 191 283 283 283 283 283 283 282 283 164 165 165 165 216 141 282 283 164 165 165 165 166 283 282 283 283 139 141 283 283 284 164 165 165 166 284 283 283 283 284 283 164 165 166 207 309 251 51 51 51 51 51 51 253 257 233 283 283 283 139 140 141 283 283 283 283 283 164 165 166 283 283 283 283 283 283 307 308 308 308 309 283 283 283 283 283 283 283 283 283 283 283 283 283 321 283 164 165 165 165 165 165 165 165 165 165 165 165 165 165 165 165 165 165 165 165 165 165 165 165 165 166 283 283 283 148 152 174 174 174 174 174 174 174 126 199 199 200 283 283 283 283 283 283 283 283 283 283 283 283 283 283 283 283 283 283 283 210 134 134 135 49 49 49 49 49 49 49 49 49 133 134 209 283 283 283 320 283 251 34 34 34 34 34 34 34 34 30 31 32 34 34 34 34 34 30 31 31 31 31 31 31 31 31 31 31 31 31 31 31 31 31 31 27 28 28 28 
165 166 283 283 283 164 166 283 283 283 322 283 283 283 189 190 190 190 190 190 190 190 190 190 190 240 165 165 165 165 241 191 283 283 283 283 283 283 283 283 282 283 164 165 165 165 165 166 282 283 164 165 165 165 166 283 282 283 283 164 166 283 283 284 164 165 241 191 284 283 159 283 284 283 164 165 166 284 226 176 51 51 51 51 51 51 253 282 283 283 139 141 164 165 166 283 321 283 283 283 189 190 191 283 139 141 283 283 283 283 283 283 283 283 283 283 320 283 283 139 141 283 283 283 283 139 140 141 283 164 165 165 165 165 165 165 165 165 165 165 165 165 165 165 165 165 165 165 165 165 165 165 165 241 191 148 149 149 152 174 174 174 174 174 174 174 174 175 283 283 283 283 283 283 283 283 283 283 283 139 141 283 283 283 334 283 283 139 141 283 283 283 283 210 134 134 134 134 134 134 134 134 134 209 283 283 283 283 283 283 283 251 34 34 34 34 34 34 34 34 30 31 32 34 34 34 34 34 30 31 31 31 31 31 31 31 31 31 31 31 31 31 31 31 31 2 78 28 28 28 
165 166 283 283 322 189 191 283 283 283 283 283 283 130 131 132 283 283 283 283 322 283 283 283 283 189 190 190 190 190 191 283 283 283 321 139 141 283 283 283 282 283 164 165 165 165 165 166 282 283 189 240 165 241 191 283 282 283 283 189 191 283 207 309 164 165 166 283 284 283 283 283 284 283 215 165 166 284 251 51 51 51 51 51 51 51 253 282 283 283 189 191 189 190 191 283 283 139 141 333 283 283 283 283 164 166 283 283 334 283 283 283 283 321 283 283 283 283 139 215 216 141 283 334 283 164 165 166 283 164 165 165 165 165 165 165 165 165 165 165 165 165 165 165 165 165 165 165 165 165 165 165 165 166 148 152 174 174 174 174 174 174 174 174 174 174 174 151 150 283 283 283 283 283 333 283 283 334 283 164 166 283 283 283 283 283 333 164 166 283 322 283 283 283 283 283 283 283 283 283 283 283 283 283 283 283 283 283 283 283 226 176 34 34 34 34 34 34 34 34 30 31 32 34 34 34 34 34 30 31 31 31 31 31 31 31 31 31 31 31 31 31 31 31 31 27 28 28 28 104 
165 166 283 283 283 283 283 283 283 321 283 130 131 82 168 83 132 321 283 283 283 283 283 283 322 283 283 283 283 283 283 283 283 283 283 164 166 283 283 257 233 283 189 240 165 241 283 191 282 283 283 283 190 191 283 257 233 283 283 283 283 283 284 283 215 165 166 207 309 283 283 283 284 164 165 165 166 284 251 51 51 5 6 7 51 51 253 282 283 283 283 283 283 283 283 283 139 215 216 141 283 283 283 283 189 191 283 283 283 283 139 141 283 283 283 283 283 283 189 240 241 191 283 283 283 189 190 191 283 164 165 165 165 165 165 165 165 165 165 165 165 165 241 283 240 165 165 165 165 165 165 165 165 166 173 174 174 174 174 174 174 174 174 174 174 174 174 174 175 283 334 283 322 283 283 283 283 283 283 189 191 283 283 333 283 283 283 189 191 283 283 333 283 283 283 283 283 333 334 283 283 283 283 283 283 334 283 322 283 283 251 34 34 34 5 6 7 34 34 34 55 56 57 34 34 34 34 34 30 31 31 31 31 31 31 31 31 31 31 31 31 31 31 31 31 27 28 28 28 79 
165 216 141 139 141 283 283 283 283 283 130 82 168 168 168 295 83 131 131 131 131 131 132 283 283 283 283 283 283 321 283 283 283 283 283 189 191 283 257 233 283 283 283 283 190 191 283 283 282 283 283 283 283 283 257 233 283 283 159 283 283 207 309 164 165 165 166 284 283 283 283 207 309 164 165 165 166 284 251 51 51 30 31 32 51 51 253 282 283 333 283 283 283 283 283 283 189 240 241 191 283 283 283 283 283 283 283 283 283 139 215 216 141 283 283 283 334 283 283 189 191 283 283 139 141 283 283 283 283 164 165 165 165 165 165 165 165 165 165 165 165 241 191 283 164 165 165 165 165 165 165 165 165 166 173 174 174 174 174 174 174 174 174 174 174 174 174 174 175 283 283 283 283 283 283 283 283 145 146 147 283 283 283 283 283 334 283 283 283 333 333 334 283 283 283 283 283 283 283 283 283 283 283 283 333 333 283 283 283 283 251 34 34 34 30 31 32 34 34 34 34 34 34 34 34 34 34 34 30 31 31 31 31 31 31 31 31 31 31 31 31 31 31 31 31 27 28 28 28 28 
165 165 166 189 191 283 320 283 283 130 82 270 168 345 168 168 168 168 168 270 168 168 83 132 283 283 320 283 283 283 283 320 283 283 283 283 283 283 282 283 283 283 283 283 283 159 283 257 233 283 283 159 283 283 282 283 283 283 283 283 283 284 283 164 165 241 191 284 283 283 283 284 283 164 165 165 166 284 251 51 51 30 31 32 51 51 253 282 283 283 139 141 283 283 283 334 283 189 191 283 333 283 283 257 258 259 283 334 283 189 240 241 191 283 283 283 283 283 283 283 283 283 283 164 166 283 283 283 283 164 165 165 165 165 165 165 165 165 165 165 165 166 159 283 189 240 165 165 165 165 165 165 165 166 173 174 174 174 174 174 174 174 174 174 174 174 174 174 175 283 283 333 283 283 283 283 145 221 283 222 146 146 147 283 283 283 283 283 283 283 333 334 283 283 139 140 140 140 140 140 140 140 140 141 283 283 283 283 283 226 176 34 34 34 30 31 32 34 34 34 34 34 34 34 34 34 34 34 30 31 31 31 31 31 31 31 31 31 31 31 31 31 31 31 31 27 28 28 28 28 
165 165 166 283 283 283 283 283 322 155 168 168 168 168 270 168 168 346 168 168 168 270 168 157 283 283 283 283 283 283 283 283 283 283 139 141 283 257 233 283 159 283 283 283 283 283 283 282 283 283 283 283 283 257 233 283 283 283 283 283 207 309 283 215 165 166 207 309 283 283 283 284 283 164 165 165 166 284 251 51 51 30 31 32 51 51 253 282 283 283 164 166 283 283 283 283 283 283 283 283 283 283 257 233 283 208 259 283 283 283 189 191 283 283 283 257 258 258 259 283 283 321 283 189 191 283 283 283 283 189 240 165 165 165 165 165 165 165 165 165 165 166 283 159 283 164 165 165 165 165 165 165 165 166 173 174 174 174 174 174 174 174 174 174 174 174 174 174 175 283 283 283 283 145 146 146 221 283 283 283 283 283 172 283 283 283 283 283 283 283 283 283 283 283 215 165 165 165 165 165 165 165 165 166 283 283 283 283 283 276 201 34 34 34 55 56 57 34 34 34 34 34 34 34 34 34 34 34 30 31 31 31 31 31 31 31 2 3 4 31 31 31 31 31 31 27 28 28 28 28 
165 165 166 283 283 283 283 283 283 155 168 270 295 168 168 347 295 168 168 345 168 168 168 83 132 283 283 320 283 322 283 139 141 283 189 191 283 282 283 139 141 283 283 159 283 283 257 233 283 283 140 141 283 282 283 283 159 283 283 283 284 283 164 165 241 191 284 283 159 283 283 284 283 215 165 241 191 284 251 51 51 30 31 32 51 51 253 282 283 283 189 191 283 283 283 283 283 283 283 283 283 257 233 283 283 283 208 259 283 283 283 283 283 283 257 233 283 283 208 258 259 283 283 283 283 283 283 283 283 283 164 165 165 165 165 165 165 165 165 165 165 166 283 283 139 215 165 165 165 165 165 165 165 166 173 174 174 174 174 174 174 174 174 174 174 174 174 174 175 283 333 283 283 170 283 283 283 283 283 159 283 283 172 283 283 283 283 283 334 283 283 283 139 215 165 165 165 165 165 165 165 165 165 216 140 141 283 283 283 283 251 34 34 34 34 34 34 34 202 277 277 201 34 34 34 34 34 34 30 31 31 31 31 31 31 31 27 28 79 4 31 31 31 31 2 78 28 28 28 28 
165 165 166 283 283 139 141 283 283 155 168 168 168 168 270 168 168 168 295 168 168 295 168 168 157 283 283 283 283 283 283 164 166 283 283 283 257 233 283 189 191 283 283 283 283 283 282 283 283 215 165 166 283 282 283 283 283 283 283 283 284 283 164 165 166 207 309 283 283 283 207 309 164 165 165 166 283 284 251 51 51 30 31 32 51 202 278 282 283 283 283 283 283 283 283 283 321 283 283 257 258 233 283 283 283 283 283 208 258 258 258 258 258 258 233 283 283 283 283 283 208 259 283 283 334 283 139 141 283 283 189 240 165 165 165 165 165 165 165 165 165 166 283 159 164 165 165 165 165 165 165 165 165 166 198 127 174 174 174 174 174 174 174 174 174 174 174 126 200 283 283 283 283 170 283 283 283 283 283 283 283 283 222 147 283 283 283 283 333 283 283 283 164 165 165 165 165 165 165 165 165 165 165 165 165 166 283 283 334 283 251 34 34 34 34 34 34 202 278 283 283 276 201 34 34 34 34 34 30 31 31 31 31 31 31 31 27 28 28 79 3 3 3 3 78 28 28 28 28 28 
165 165 216 141 139 215 216 141 283 155 168 347 168 270 168 346 168 168 168 168 295 168 345 168 157 322 283 283 283 283 283 189 191 283 283 283 282 283 283 283 140 140 141 283 283 257 233 283 164 165 165 166 283 282 283 283 139 141 283 283 284 283 189 190 191 284 283 283 283 283 284 283 164 165 165 166 207 309 251 51 51 55 56 57 51 253 257 233 283 334 283 283 139 140 141 283 283 283 257 233 283 283 283 139 140 140 140 140 140 140 140 140 140 140 140 140 140 140 140 141 283 208 259 283 283 139 215 216 141 283 283 189 240 165 165 165 165 165 165 165 165 216 141 283 164 165 165 165 165 165 165 165 165 216 141 198 127 174 174 174 174 174 174 174 174 174 126 200 283 283 283 283 145 221 283 283 283 283 283 283 283 159 283 222 147 283 283 283 283 283 322 283 164 165 165 165 165 165 165 165 165 165 165 165 165 166 283 333 283 283 251 34 34 34 34 34 202 278 283 283 322 283 251 34 34 34 34 34 30 31 31 31 31 31 31 31 27 28 28 28 28 28 28 28 28 28 28 28 28 28 
165 165 165 166 189 240 241 191 283 180 107 168 168 168 168 168 270 168 345 168 168 168 168 168 157 283 283 283 139 141 283 283 139 140 141 283 282 283 283 215 165 165 166 283 283 282 283 283 164 165 165 166 283 282 283 283 164 166 283 283 208 259 283 283 283 284 283 283 283 207 309 283 164 165 165 166 284 226 176 51 51 51 51 51 51 253 282 283 283 283 283 283 164 165 166 283 283 283 282 283 283 283 283 215 165 165 165 165 165 165 165 165 165 165 165 165 165 165 165 216 283 283 208 259 283 189 240 241 191 333 283 283 189 240 165 165 165 165 165 165 165 165 216 141 164 165 165 165 165 165 165 165 165 165 216 141 198 199 199 127 174 174 174 174 126 199 200 283 283 283 283 145 221 283 283 159 139 140 140 141 283 283 283 283 172 283 283 283 334 283 283 283 164 165 165 165 165 165 165 165 165 165 165 165 165 166 283 283 283 283 251 34 34 34 34 34 253 283 139 140 141 283 251 34 34 34 34 34 55 105 31 31 31 31 31 31 52 53 53 53 53 103 28 28 28 28 28 28 28 28 
165 165 165 166 283 189 191 283 283 283 180 107 295 168 295 168 168 168 168 168 346 168 270 108 182 283 321 283 164 166 283 283 189 190 191 283 282 283 164 165 165 165 166 283 257 233 283 283 164 165 165 166 283 282 283 283 189 191 283 283 283 284 283 283 283 284 283 283 283 284 283 283 215 165 241 191 284 251 51 51 51 51 51 51 202 278 282 283 283 283 283 283 189 190 191 283 283 283 282 283 139 140 215 165 165 165 165 165 165 165 165 165 165 165 165 165 165 165 165 165 216 141 283 208 259 283 189 191 283 283 283 283 283 164 165 165 165 165 165 165 165 165 165 216 215 165 165 165 165 165 165 165 165 165 165 216 141 283 283 198 199 199 199 199 200 283 283 334 283 283 145 221 283 283 283 139 215 165 165 216 141 283 283 283 222 147 283 283 333 333 283 283 189 240 165 165 165 165 165 165 165 165 165 165 165 166 320 283 283 283 251 34 286 34 34 34 253 283 164 165 166 283 251 34 34 34 34 34 34 55 105 31 31 31 31 31 31 31 31 31 31 52 103 28 28 28 28 28 28 28 
165 165 165 166 283 283 283 283 283 322 283 180 181 107 168 168 347 168 270 168 168 168 108 182 283 320 283 283 189 191 283 283 283 283 283 283 282 283 164 165 165 165 166 283 307 232 283 283 164 165 165 166 283 307 232 283 283 283 139 141 283 284 283 283 283 284 283 283 283 284 283 164 165 165 166 207 309 251 51 51 51 51 51 51 253 257 233 283 283 283 283 283 283 283 283 322 283 257 233 283 215 165 165 165 165 165 165 165 165 165 165 165 165 165 165 165 165 165 165 165 165 166 283 283 284 283 283 283 283 283 283 283 283 189 240 165 165 165 165 165 165 165 165 165 165 165 165 165 165 165 165 165 165 165 165 165 166 283 283 283 283 283 283 283 283 283 283 283 283 283 170 283 283 283 139 215 165 165 165 165 216 141 283 283 283 172 283 283 283 283 283 283 283 283 165 165 165 165 165 165 165 165 165 165 165 166 283 283 333 283 251 34 286 34 34 34 253 283 189 190 191 283 251 34 34 34 34 34 34 34 30 31 31 31 31 31 31 31 31 31 31 31 52 103 28 28 28 28 28 28 
165 165 165 166 283 283 283 283 320 283 283 283 283 180 181 181 181 181 181 181 181 181 182 283 283 283 283 283 322 283 283 283 322 283 283 283 282 283 164 165 165 165 216 141 283 282 283 283 164 165 165 216 141 283 282 283 283 159 189 191 283 284 283 283 207 309 283 283 283 284 283 215 165 241 191 284 226 176 51 51 51 51 51 51 253 282 283 283 283 333 283 283 321 283 283 283 283 282 139 215 165 165 165 165 165 165 165 165 165 165 165 165 165 165 165 165 165 165 165 165 165 166 283 283 284 283 283 283 283 283 321 283 283 283 164 165 165 165 165 165 165 165 165 165 165 165 165 165 165 165 165 165 165 165 165 241 191 283 283 283 283 283 320 283 283 333 283 320 283 283 170 283 283 139 215 165 165 165 165 165 165 166 159 283 283 172 283 283 283 283 283 320 139 215 165 165 165 165 165 165 165 165 165 165 241 191 283 283 283 283 251 286 286 34 237 236 253 283 333 283 333 226 176 34 34 34 34 34 34 34 55 105 31 31 31 31 31 31 31 31 31 31 31 27 28 28 28 28 28 28 
165 165 165 166 283 283 283 283 283 139 141 322 283 283 283 283 283 283 283 283 283 283 283 322 283 283 140 140 140 140 141 283 283 283 283 283 282 283 189 240 165 165 165 166 283 282 283 283 164 165 165 165 166 283 282 283 283 283 283 283 283 284 283 283 284 283 139 141 283 284 164 165 165 166 283 284 251 51 51 51 51 51 51 202 278 282 283 334 283 283 139 141 283 283 283 283 283 282 164 165 165 165 165 165 165 165 165 165 165 165 165 165 165 165 165 165 165 165 165 165 165 166 283 283 284 283 139 140 141 333 283 283 139 140 215 165 165 165 165 165 165 165 165 165 165 165 165 165 165 165 165 165 165 165 241 191 283 283 283 334 283 283 283 283 283 283 283 283 283 145 221 283 283 164 165 165 165 165 165 165 165 166 283 283 283 172 283 283 283 139 141 283 164 165 165 165 165 165 165 165 241 190 190 190 191 283 283 283 283 226 176 286 286 34 212 211 177 228 283 334 283 251 34 34 34 34 34 34 34 34 34 30 31 31 31 31 31 31 31 31 31 31 31 27 28 28 28 28 28 28 
165 165 165 166 283 283 283 283 283 164 166 283 283 283 283 322 283 321 283 322 283 283 283 283 283 215 165 165 165 165 166 283 283 283 283 283 282 283 283 189 240 165 165 166 283 307 232 283 189 240 165 165 166 283 307 232 283 283 139 141 283 284 283 283 284 283 164 166 283 284 164 165 165 166 207 309 251 51 51 51 51 51 51 253 257 233 283 283 283 139 215 216 141 334 283 283 257 233 215 165 165 165 165 165 165 165 241 190 190 190 190 240 165 165 165 165 165 165 165 165 165 216 283 283 284 283 164 165 166 283 283 139 215 165 165 165 165 165 165 165 165 165 165 165 165 165 165 165 165 165 165 165 165 241 191 283 283 283 333 283 283 283 283 283 334 283 333 283 283 170 283 283 283 164 165 165 165 165 165 165 165 166 283 159 283 222 147 283 283 164 166 283 164 165 165 165 165 165 165 165 166 283 283 322 283 333 334 283 226 176 34 286 286 34 34 34 34 177 228 283 283 251 34 34 34 34 34 34 34 34 34 30 31 31 31 31 31 31 31 31 31 31 31 27 28 28 28 28 28 28 
165 165 165 166 283 322 283 283 283 189 191 283 320 283 283 139 141 283 283 283 320 283 283 283 164 165 165 165 165 165 216 141 283 283 283 283 282 283 283 283 189 240 165 166 283 283 282 283 283 164 165 165 166 283 283 282 283 283 164 166 283 284 283 283 284 283 189 191 283 284 164 165 165 166 284 226 176 51 51 51 51 51 51 253 282 283 283 283 283 189 240 241 191 283 283 257 233 164 165 165 165 165 165 165 165 241 191 283 322 283 283 189 190 240 165 165 165 165 165 165 165 165 216 141 284 283 189 190 191 283 139 215 165 165 165 165 165 165 165 165 165 165 165 165 165 165 165 165 165 165 165 165 165 166 283 283 333 283 283 283 283 283 322 283 333 283 283 283 283 170 283 159 283 164 165 165 165 165 165 165 165 166 283 283 283 283 172 283 283 189 191 283 164 165 165 165 165 165 165 241 191 283 333 283 283 283 283 283 251 34 34 34 286 34 34 237 236 34 177 227 227 176 34 34 34 34 34 34 34 34 34 30 31 31 31 31 31 31 31 31 31 31 31 27 28 28 28 28 28 28 
165 165 165 166 283 283 283 283 283 283 283 283 283 283 283 164 166 283 283 283 283 283 283 283 164 165 165 165 165 165 165 166 283 321 283 283 307 232 283 283 283 189 190 191 283 283 307 232 283 164 165 165 166 283 283 282 283 283 189 191 283 284 283 283 284 283 283 283 283 284 164 165 165 166 284 251 51 51 51 51 51 51 51 253 282 283 283 283 283 283 189 191 283 283 283 282 283 164 165 165 165 165 165 241 190 191 334 283 283 334 283 283 283 189 240 165 165 165 165 165 165 165 165 166 284 283 283 283 283 139 215 165 165 165 165 165 165 165 165 165 165 165 165 165 165 165 165 165 165 165 165 165 241 191 283 283 283 283 283 283 283 283 283 283 283 283 283 283 283 170 283 283 283 189 240 165 165 165 165 165 241 191 283 283 159 283 172 283 283 283 283 283 164 165 165 165 165 165 241 191 283 334 283 283 283 283 283 283 251 34 34 34 34 286 34 212 211 34 34 34 34 34 34 34 34 34 34 34 34 34 34 30 31 31 31 31 31 31 31 31 31 31 31 27 28 28 28 28 28 28
