20x20.bmp 300:24
28 28 28 28 28 28 28 28 28 28 28 79 4 31 31 31 31 31 31 31 31 31 31 31 31 31 31 31 31 31 31 31 31 31 31 81 7 37 37 37 37 37 37 37 37 37 37 37 37 37 37 37 37 37 37 37 37 37 37 37 37 37 37 37 37 37 37 37 37 37 37 37 37 37 37 37 37 37 37 37 37 37 37 37 37 37 37 37 37 37 37 37 37 37 37 37 37 293 40 40 40 40 40 40 40 40 40 40 40 40 40 40 40 40 40 40 40 40 40 40 39 40 40 40 40 40 40 40 40 39 40 40 40 40 40 40 40 39 40 47 43 43 43 70 121 39 40 40 40 40 40 40 40 47 76 76 76 76 76 76 76 133 134 135 48 158 102 102 102 102 160 48 158 102 102 102 102 102 102 102 102 102 102 102 102 160 48 158 102 102 102 102 102 102 102 102 102 102 102 102 160 48 76 76 76 76 76 76 367 289 289 289 390 289 289 289 289 289 289 289 289 391 289 289 289 288 289 362 363 363 363 363 363 363 341 313 238 289 289 362 363 363 363 341 339 288 289 289 289 289 289 289 313 238 289 289 289 289 289 289 289 289 390 289 289 289 390 289 289 298 299 299 299 244 245 299 299 299 299 219 220 299 300 271 387 388 389 289 289 362 363 364 289 289 289 362 363 364 337 338 
28 28 28 28 28 28 28 28 28 28 28 28 79 4 31 31 31 31 31 31 31 31 31 31 31 31 31 31 31 31 31 31 31 31 31 31 32 37 37 37 37 37 37 37 37 37 37 37 37 37 37 37 37 37 37 37 37 37 37 37 37 37 37 37 37 37 37 37 37 37 37 37 37 37 37 37 37 37 37 37 37 37 37 37 37 37 37 37 37 37 37 37 37 37 37 37 37 218 267 267 268 40 40 40 40 40 40 40 40 40 40 40 40 40 40 40 40 40 40 40 64 115 40 40 40 40 40 40 40 64 115 40 40 40 40 40 40 39 122 72 43 43 43 43 45 39 40 40 40 40 40 40 40 47 76 76 76 76 76 76 133 209 102 160 48 158 102 159 102 102 160 48 158 102 102 102 102 320 102 102 322 102 102 321 102 160 48 158 102 322 102 102 102 322 102 102 320 102 322 102 160 48 76 76 76 76 76 76 392 153 289 391 289 289 289 337 338 338 338 339 289 289 289 390 289 313 238 289 365 363 363 363 363 363 363 364 313 238 289 387 365 363 363 363 364 313 238 289 289 391 289 289 289 313 238 289 289 289 391 289 289 289 289 289 289 289 289 289 289 298 219 220 299 299 299 299 299 299 299 244 245 299 300 296 289 289 289 289 289 387 388 389 289 289 289 387 388 389 362 363 
28 28 28 28 28 28 28 28 28 28 28 28 28 79 4 31 31 31 31 31 31 31 31 31 31 31 31 31 31 31 31 31 31 31 31 31 81 7 37 37 37 37 37 37 37 37 37 37 37 37 37 37 37 37 37 37 37 37 37 37 37 37 37 37 37 37 37 37 37 37 37 37 37 37 37 37 37 37 37 37 37 37 37 37 37 37 37 37 37 37 37 37 37 37 37 37 37 37 37 37 218 267 268 40 40 40 40 40 40 40 40 40 40 40 40 40 40 40 40 40 40 64 115 40 40 40 40 40 40 40 39 40 40 40 40 40 40 39 47 43 43 43 43 43 45 39 40 40 40 40 40 40 40 47 76 76 76 76 76 133 209 102 102 160 48 158 102 102 102 102 160 48 183 234 102 322 102 102 102 102 102 102 102 102 235 185 48 158 102 102 102 321 102 102 102 102 102 102 102 102 160 48 76 76 76 76 76 76 76 392 153 289 289 390 289 362 363 363 363 341 338 289 289 289 289 289 288 289 387 365 363 363 363 363 363 341 339 313 238 289 362 363 363 363 364 289 288 289 289 289 337 338 339 289 313 238 289 289 289 289 289 391 289 289 391 289 289 289 289 298 244 245 299 299 299 299 299 299 299 299 299 299 300 296 289 289 289 395 289 289 289 289 289 395 289 289 289 289 387 388 
28 28 28 28 28 28 28 28 28 28 28 28 28 28 79 3 4 31 31 31 31 31 31 31 31 31 31 31 31 31 31 31 31 31 31 31 31 81 7 37 37 37 37 37 37 37 37 37 37 37 37 37 37 37 37 37 37 37 37 37 37 37 37 37 37 37 37 37 37 37 37 37 37 37 37 37 37 37 37 37 37 37 37 37 37 37 37 37 37 37 37 37 37 37 37 37 37 37 37 37 37 37 218 267 268 40 40 40 40 40 40 40 40 40 40 40 40 40 40 40 40 40 64 115 40 40 40 40 40 40 39 40 40 40 40 40 40 39 47 43 43 43 43 20 96 39 40 266 267 268 40 40 40 47 76 76 76 76 76 158 102 102 102 160 48 158 102 321 102 102 160 73 123 158 320 102 102 139 140 140 140 141 102 235 185 23 98 158 102 139 140 140 141 102 320 102 102 102 102 102 160 48 76 76 76 76 76 76 76 76 392 153 289 289 289 362 363 363 363 363 363 341 338 289 289 289 313 238 289 387 365 363 363 363 363 363 364 289 288 289 362 363 363 363 364 289 288 289 289 289 362 363 341 289 289 288 289 289 390 289 289 289 289 289 289 390 289 289 289 298 299 299 299 299 299 299 219 220 299 299 299 299 300 296 289 289 289 289 289 289 289 289 289 289 289 289 289 395 289 289 
28 28 28 28 28 28 28 28 28 28 28 28 28 28 28 28 79 4 31 31 31 31 31 31 31 31 31 31 31 31 31 31 31 31 31 31 31 31 81 7 37 37 37 37 37 37 37 37 37 37 37 37 37 37 37 37 37 37 37 37 37 37 37 37 37 37 37 37 37 37 37 37 37 37 37 37 37 37 37 37 37 37 37 37 37 37 37 37 37 37 37 37 37 37 37 37 37 37 37 37 37 37 37 37 293 40 40 40 40 40 40 40 40 40 266 267 268 40 40 40 40 40 40 64 115 40 40 40 40 40 64 115 122 71 71 71 121 39 47 43 43 43 43 45 14 90 40 291 292 293 40 40 40 47 76 76 76 76 76 158 102 102 102 160 48 158 102 102 102 102 210 135 48 158 102 102 139 215 165 165 165 166 235 185 23 98 133 209 139 215 165 165 216 141 102 102 322 102 322 102 160 48 76 76 76 76 76 76 76 76 76 392 153 289 289 362 363 363 363 363 363 363 363 341 338 339 289 288 289 289 362 363 363 363 363 363 341 339 288 289 387 365 363 363 341 339 313 238 289 289 362 363 363 341 339 288 289 289 289 289 289 289 289 390 289 289 391 289 289 298 299 299 299 299 299 299 244 245 299 219 220 299 300 296 289 289 289 289 289 337 338 339 289 289 337 338 339 289 289 337 
28 28 28 28 28 28 28 28 28 28 28 28 28 28 28 28 28 79 3 4 31 31 31 31 31 31 31 31 31 31 31 31 31 31 31 31 31 31 31 81 6 7 37 37 37 37 37 37 37 37 37 37 37 37 37 37 37 37 37 37 37 37 37 37 37 37 37 37 37 37 37 37 37 37 37 37 37 37 37 37 37 37 37 37 37 37 37 37 37 37 37 37 37 37 37 37 37 37 37 37 37 37 37 37 218 268 40 40 40 40 40 40 40 40 291 292 293 40 40 40 40 40 40 40 64 115 40 40 40 40 40 39 47 43 43 43 45 39 47 43 43 43 43 45 39 40 40 316 317 318 40 40 40 47 76 76 76 76 76 183 234 102 102 160 48 158 102 102 320 102 102 160 48 183 234 102 164 165 165 165 165 166 160 23 98 133 209 139 215 165 165 165 165 216 141 102 102 102 102 102 160 48 76 76 76 76 76 76 76 76 76 76 392 153 289 362 363 363 363 363 363 363 363 363 363 341 289 313 238 289 362 363 363 363 363 363 363 364 313 238 289 362 363 363 363 364 289 288 289 289 362 363 363 363 364 313 238 289 289 289 391 289 289 289 289 289 289 289 289 298 299 219 220 299 299 299 299 299 299 244 245 299 300 296 289 289 289 289 289 362 363 364 289 289 362 363 364 289 289 362 
28 28 28 28 28 28 28 28 28 28 28 28 28 28 28 28 28 28 28 79 4 31 31 31 31 31 31 31 31 31 31 31 31 31 31 31 31 31 31 31 31 81 6 7 37 37 37 37 37 37 37 37 37 37 37 37 37 37 37 37 37 37 37 37 37 37 37 5 6 6 6 6 6 6 7 37 37 37 37 37 37 37 37 37 37 37 37 37 37 37 37 37 37 37 37 37 37 37 37 37 37 37 37 37 37 218 267 268 40 40 40 40 40 40 316 317 318 40 40 40 40 40 40 40 40 39 40 40 40 40 40 39 47 43 43 43 45 39 47 43 43 43 43 45 39 40 40 40 40 40 40 40 40 97 22 76 76 76 76 76 183 234 102 160 48 158 102 102 102 102 102 160 73 123 158 102 164 165 165 165 165 166 160 48 133 209 102 164 165 165 165 165 165 165 216 141 102 102 321 102 160 48 76 76 76 76 76 76 76 76 76 76 76 367 289 289 365 363 363 363 363 363 363 363 363 363 364 289 288 289 362 363 363 363 363 363 363 364 289 288 289 362 363 363 363 341 339 313 238 289 387 365 363 363 341 339 313 238 289 289 289 289 289 289 289 289 289 289 289 298 299 244 245 299 299 299 299 299 299 299 299 299 300 296 337 338 339 289 289 387 388 389 289 289 387 388 389 289 289 387 
28 28 28 28 28 28 28 28 28 28 28 28 28 28 28 28 28 28 28 28 79 3 4 31 31 31 31 31 31 31 31 31 31 31 31 31 31 31 31 31 31 31 31 81 6 7 37 37 37 37 37 37 37 37 37 37 37 37 37 37 37 37 37 37 37 5 6 80 31 31 31 31 31 31 81 6 7 37 37 37 37 37 37 37 37 37 37 37 37 37 37 37 37 37 37 37 37 37 37 37 37 37 37 37 37 37 37 218 268 40 40 40 40 40 40 40 40 266 267 267 267 267 268 40 40 39 40 40 40 40 40 39 47 43 43 43 45 39 47 43 43 43 20 96 39 40 40 40 40 40 40 40 40 40 47 76 76 76 76 76 76 183 184 185 48 183 234 102 102 102 102 210 135 48 183 234 164 165 165 165 165 166 160 48 158 102 102 164 165 165 165 165 165 165 165 216 141 102 102 235 185 48 76 76 76 76 76 76 76 76 76 76 76 367 289 289 289 365 363 363 363 363 363 363 363 363 341 289 313 238 387 365 363 363 363 363 363 364 289 288 289 362 363 363 363 363 364 289 313 238 289 362 363 363 363 364 289 288 289 289 289 289 289 395 390 289 289 289 289 323 324 324 324 324 324 324 324 324 324 324 324 324 325 296 362 363 364 263 264 264 264 264 264 264 264 265 289 289 289 289 
28 28 28 28 28 28 28 28 28 28 28 28 28 28 28 28 28 28 28 28 28 28 79 3 4 31 31 31 31 31 31 31 31 31 31 31 31 31 31 31 31 31 31 31 31 81 6 7 37 37 37 37 37 37 37 37 37 37 37 37 37 37 37 37 5 80 31 31 31 31 31 31 31 31 31 31 81 6 7 37 37 37 37 37 37 37 37 37 37 37 37 37 37 37 37 37 37 37 37 37 37 37 37 37 37 37 37 37 218 268 40 40 40 40 40 40 40 291 292 292 292 292 293 40 40 64 115 40 40 40 40 39 47 43 43 43 45 39 97 21 21 21 96 14 90 40 40 40 40 40 40 40 40 40 97 22 76 76 76 76 76 76 76 76 73 123 158 102 102 102 102 102 160 73 123 158 164 165 165 165 165 166 160 48 158 102 102 164 165 165 165 165 165 165 165 165 166 102 235 185 23 98 76 76 76 76 76 76 76 76 76 76 76 392 153 289 289 362 363 363 363 363 363 363 363 363 363 341 339 288 289 362 363 363 363 363 363 364 289 288 289 387 365 363 363 363 364 289 289 288 289 362 363 363 363 341 339 313 238 289 390 289 391 289 289 289 391 289 289 348 349 349 349 349 349 349 349 349 349 349 349 349 350 296 387 388 389 288 289 289 289 289 289 289 289 290 289 289 289 289 
28 28 28 28 28 28 28 28 28 28 28 28 28 28 28 28 28 28 28 28 28 28 28 28 79 3 4 31 31 31 31 31 31 31 31 31 31 31 31 31 31 31 31 31 31 31 31 81 6 7 37 37 37 37 37 37 37 37 37 37 37 5 6 6 80 31 31 31 31 31 31 31 31 31 31 31 31 31 81 6 7 37 37 37 37 37 37 37 37 37 37 37 37 37 37 37 37 37 37 37 37 37 37 37 37 37 37 37 37 218 268 40 40 40 40 40 40 291 292 292 292 292 293 40 40 40 39 40 40 40 40 39 47 43 43 43 45 39 40 40 40 40 40 39 40 40 40 40 40 40 40 40 40 40 40 47 76 76 76 76 76 76 76 76 76 48 158 102 139 140 141 102 210 135 48 158 189 240 165 165 241 191 160 48 158 102 320 164 165 165 165 165 165 165 165 165 166 235 185 23 98 76 76 76 76 76 76 76 76 76 76 76 76 76 367 289 289 362 363 363 363 363 363 363 363 363 363 363 364 288 289 362 363 363 363 363 366 389 289 288 289 289 362 363 363 363 341 339 289 313 238 362 363 363 363 363 364 289 288 289 289 289 289 289 289 289 289 289 289 373 374 374 374 374 374 374 374 374 374 374 374 374 375 296 289 289 289 288 289 337 338 339 289 289 289 290 289 395 289 289 
28 28 28 28 28 28 28 28 28 28 28 28 28 28 28 28 28 28 28 28 28 28 28 28 28 28 79 4 31 31 31 31 31 31 31 31 31 31 31 31 31 31 31 31 31 31 31 31 31 81 6 7 37 37 37 37 37 37 37 37 5 80 31 31 31 31 31 31 31 31 31 31 31 31 31 31 31 31 31 31 81 7 37 37 37 37 37 37 37 37 37 37 37 37 37 37 37 37 37 37 37 37 37 37 37 37 37 37 37 37 218 268 40 40 40 40 40 291 292 292 292 292 293 40 40 40 39 40 40 40 40 39 47 43 43 43 45 39 40 40 40 40 40 39 40 40 40 40 40 40 40 40 40 40 40 47 76 76 76 76 76 76 76 76 76 48 158 102 164 165 166 102 102 160 48 158 102 189 190 190 191 102 160 48 158 102 102 164 165 165 165 165 165 165 165 165 166 160 23 98 76 76 76 76 76 76 76 76 76 76 76 76 76 76 392 153 289 362 363 363 363 363 363 363 363 363 363 363 364 313 238 387 365 363 363 366 389 289 289 313 238 289 362 363 363 363 363 364 289 289 288 387 365 363 363 363 364 289 288 289 289 289 390 289 289 289 289 289 289 398 297 297 297 297 297 297 297 297 297 297 297 297 297 400 289 289 289 288 289 362 363 364 395 289 289 290 289 289 289 289 
28 28 28 28 28 28 28 28 28 28 28 28 28 28 28 28 28 28 28 28 28 28 28 28 28 28 28 79 3 4 31 31 31 31 31 31 31 31 31 31 31 31 31 31 31 31 31 31 31 31 31 81 6 7 37 37 37 37 5 6 80 31 31 31 31 31 31 31 31 31 31 31 31 31 31 31 31 31 31 31 31 81 7 37 37 37 37 37 37 37 37 37 37 37 37 37 37 37 37 37 37 37 37 37 37 37 37 37 37 37 37 218 268 40 40 40 40 316 317 317 317 317 318 40 40 40 39 40 40 40 40 39 47 43 43 43 45 39 40 40 40 40 40 39 40 40 40 40 40 40 40 40 40 40 40 47 76 76 76 76 76 76 76 76 76 48 158 321 189 190 191 102 322 160 48 158 102 321 102 102 102 102 160 48 158 102 102 164 165 165 165 165 165 165 165 165 166 160 48 76 133 134 134 134 134 135 76 76 76 76 76 76 76 76 76 392 153 289 365 363 363 363 363 363 363 363 363 363 364 289 288 289 387 388 388 389 289 289 390 289 288 289 362 363 363 363 363 341 339 289 288 289 362 363 363 363 364 289 313 238 289 289 289 289 391 289 289 289 289 289 289 289 390 289 289 289 289 289 289 289 289 289 289 289 289 289 289 288 289 387 388 389 338 339 289 290 289 289 289 289 
28 28 28 28 28 28 28 28 28 28 28 28 28 28 28 28 28 28 28 28 28 28 28 28 28 28 28 28 28 79 3 4 31 31 31 31 31 31 31 31 31 31 31 31 31 31 31 31 31 31 31 31 31 32 37 37 5 6 80 31 31 31 31 31 31 31 31 31 31 31 31 31 31 31 31 31 31 31 31 31 31 31 81 7 37 37 37 37 37 37 37 37 37 37 37 37 37 37 37 37 37 37 37 37 37 37 37 37 37 37 37 37 218 268 40 40 40 40 40 40 40 40 40 40 40 40 39 40 40 40 40 39 47 43 43 43 45 39 40 40 40 40 40 39 40 40 40 40 40 40 266 267 268 40 40 47 76 76 76 76 76 76 76 76 76 48 158 102 102 102 102 102 102 160 48 158 102 102 139 140 141 102 160 48 158 102 102 215 165 165 165 165 165 165 165 165 166 160 48 76 158 102 102 102 102 210 134 135 76 76 76 76 76 76 76 76 367 289 362 363 363 363 363 363 363 363 363 363 364 289 288 289 289 289 289 289 391 289 289 289 288 289 362 363 363 363 363 363 364 289 288 289 387 365 363 363 364 289 289 288 289 289 391 289 289 289 289 390 289 289 391 289 289 289 289 289 289 289 391 289 289 390 289 289 289 289 289 288 289 395 289 362 363 364 289 290 289 337 338 339 
28 28 28 28 28 28 28 28 28 28 28 28 28 28 28 28 28 28 28 28 28 28 28 28 28 28 28 28 28 28 28 79 4 31 31 31 31 31 31 31 31 31 31 31 31 31 31 31 31 31 31 31 31 81 6 6 80 31 31 31 31 31 31 31 31 2 3 3 4 31 31 31 31 31 31 31 31 31 31 31 31 31 31 32 37 37 37 37 37 37 37 37 37 37 37 37 37 37 37 37 37 37 37 37 37 37 37 37 37 37 37 37 37 293 40 40 40 40 40 40 40 40 40 40 40 40 39 40 40 40 40 39 47 43 43 43 45 39 40 40 40 40 40 39 40 40 40 40 40 40 291 292 293 40 40 47 76 76 76 76 76 76 76 76 76 48 158 102 102 322 102 102 102 160 48 158 102 102 164 165 166 102 160 48 158 320 164 165 165 165 165 165 165 165 165 165 166 160 48 76 158 102 102 102 102 102 102 160 76 76 76 76 76 76 76 76 392 153 289 365 363 363 363 363 363 363 363 363 364 289 288 289 289 391 289 289 289 289 289 289 288 289 362 363 363 363 363 363 341 339 313 238 289 362 363 363 341 339 289 288 289 289 289 289 289 289 289 289 289 289 289 289 289 289 289 391 289 289 289 289 289 289 289 289 289 289 289 288 289 289 289 387 388 389 289 290 289 362 363 364 
28 28 28 28 28 28 28 28 28 28 28 28 28 28 28 28 28 28 28 28 28 28 28 28 28 28 28 28 28 28 28 28 79 4 31 31 31 31 31 31 31 31 31 31 31 31 31 31 31 31 31 31 31 31 31 31 31 31 31 31 31 31 31 2 3 78 28 28 79 3 3 3 3 4 31 31 31 31 31 31 31 31 31 81 7 37 37 37 37 37 37 37 37 37 37 37 37 37 37 37 37 37 37 37 37 37 37 37 37 37 37 37 37 218 268 40 40 40 40 40 40 266 267 268 40 40 39 40 40 40 40 39 47 43 43 43 45 39 122 71 71 71 121 39 40 40 40 40 40 40 316 317 318 40 122 72 76 76 76 76 76 76 76 76 76 48 158 102 102 102 102 102 102 160 48 158 322 102 189 190 191 102 160 48 158 102 164 165 165 165 165 165 165 165 165 165 166 160 48 76 158 102 102 102 102 102 102 160 76 76 76 76 76 76 76 76 76 367 289 362 363 363 363 363 363 363 363 363 364 289 288 289 289 289 289 390 289 289 390 289 288 289 362 363 363 363 363 363 363 364 289 288 289 362 363 363 363 364 289 288 289 289 289 289 390 395 289 289 289 273 274 274 274 274 274 274 274 274 274 274 274 274 275 289 289 289 289 288 289 289 289 289 289 289 289 290 289 387 388 389 
28 28 28 28 28 28 28 28 28 28 28 28 28 28 28 28 28 28 28 28 28 28 28 28 28 28 28 28 28 28 28 28 28 29 31 31 31 31 31 31 31 31 31 31 31 31 31 31 31 31 31 31 31 31 31 31 31 31 31 31 31 31 2 78 28 28 28 28 28 28 28 28 28 79 3 4 31 31 31 31 31 31 31 31 32 37 37 37 37 37 37 37 37 37 37 37 37 37 37 37 37 37 37 37 37 37 37 37 37 37 37 37 37 37 293 40 40 40 40 40 40 291 292 293 40 40 39 40 40 40 40 39 97 21 21 21 96 39 47 43 43 43 45 39 40 40 40 40 40 40 40 40 40 40 47 76 76 76 76 76 76 76 76 76 76 48 158 139 140 141 102 102 102 160 48 158 102 102 102 102 322 102 160 48 158 102 164 165 165 165 165 165 165 165 165 165 166 160 48 76 158 102 102 102 102 102 102 160 76 76 76 76 76 76 76 76 76 392 153 362 363 363 363 363 363 363 363 363 364 289 288 289 337 338 338 338 338 338 339 289 288 289 362 363 363 363 363 363 363 364 289 288 289 362 363 363 363 364 289 288 289 289 289 289 289 289 289 289 289 298 299 299 299 299 299 299 299 299 299 299 299 299 300 271 289 289 289 313 314 314 314 314 314 314 314 315 289 289 289 289 
28 28 28 28 28 28 28 28 28 28 28 28 28 28 28 28 28 28 28 28 28 28 28 28 28 28 28 28 28 28 28 28 28 79 4 31 31 31 31 31 31 31 31 31 31 31 31 31 31 31 31 31 31 31 31 31 31 31 31 31 31 31 27 28 28 28 28 28 28 28 28 28 28 28 28 29 31 31 31 31 31 31 31 31 32 37 37 37 37 37 37 37 37 37 37 37 37 37 37 37 37 37 37 37 37 37 37 37 37 37 37 37 37 37 293 40 40 40 40 40 40 316 317 318 40 40 39 40 40 40 40 39 40 40 40 40 14 90 47 43 43 43 45 39 40 40 40 40 40 40 40 40 40 40 47 76 76 76 76 76 76 76 76 76 76 48 158 164 165 166 102 320 102 160 48 158 102 321 102 102 102 102 160 48 158 102 164 165 165 165 165 165 165 165 165 165 166 160 48 76 158 102 102 102 102 102 102 160 76 76 76 76 76 76 76 76 76 76 367 362 363 363 363 363 363 363 363 363 364 289 288 289 362 363 363 363 363 363 364 289 313 238 362 363 363 363 363 363 363 364 289 288 289 362 363 363 363 364 289 288 289 390 289 289 289 289 391 289 289 298 219 220 299 299 299 299 299 299 219 220 299 299 300 296 337 338 339 289 289 289 289 289 289 289 289 289 289 289 289 289 
28 28 28 28 28 28 28 28 28 28 28 28 28 28 28 28 28 28 28 28 28 28 28 28 28 28 28 28 28 28 28 28 28 28 29 31 31 31 31 31 31 31 31 31 31 31 31 31 31 31 31 106 105 31 31 31 31 31 31 31 31 31 27 28 28 28 28 28 28 28 28 28 28 28 28 79 4 31 31 31 31 31 31 31 81 7 37 37 37 37 37 37 37 37 37 37 37 37 37 37 37 37 37 37 37 37 37 37 37 37 37 37 37 37 218 268 40 40 40 40 40 40 40 40 40 40 39 40 40 40 40 39 40 40 40 40 39 40 47 43 43 43 45 39 40 40 40 40 40 40 40 40 40 122 72 76 76 76 76 76 76 76 76 76 76 48 158 189 190 191 102 102 235 185 48 158 102 102 102 320 102 102 160 48 158 102 164 165 165 165 165 165 165 165 165 165 166 160 48 76 158 102 102 102 102 102 235 185 76 76 76 76 76 76 76 76 76 76 367 362 363 363 363 363 363 363 363 366 389 289 288 289 362 363 363 363 363 363 341 339 289 288 362 363 363 363 363 363 363 364 289 288 289 362 363 363 363 364 289 288 289 289 289 289 395 289 289 289 289 298 244 245 299 219 220 299 299 299 244 245 299 299 300 296 362 363 364 289 337 338 339 289 289 289 289 289 337 338 339 289 
28 28 28 28 28 28 28 28 28 28 28 28 28 28 28 28 28 28 28 28 28 28 28 28 28 28 28 28 28 28 28 28 28 28 29 31 31 31 31 31 31 31 31 31 31 31 31 31 31 106 56 57 55 56 105 31 31 31 31 31 31 31 27 28 28 28 28 28 28 28 28 28 28 28 28 28 79 4 31 31 31 31 31 31 31 32 37 37 37 37 37 37 37 37 37 37 37 37 37 37 37 37 37 37 37 37 37 37 37 37 37 37 37 37 37 293 40 40 40 40 40 40 40 40 40 40 39 40 40 40 14 90 40 40 40 40 39 40 47 43 43 43 45 39 40 40 40 40 40 40 40 40 40 47 76 76 76 76 76 76 76 76 76 76 76 48 158 102 102 102 102 102 160 23 98 158 102 102 322 102 102 102 160 48 158 102 164 165 165 165 165 165 165 165 165 241 191 160 48 76 158 102 102 102 102 102 160 76 76 76 76 76 76 76 76 76 76 76 367 289 365 363 363 363 363 363 363 364 289 289 288 337 340 363 363 363 363 363 363 341 339 288 362 363 363 363 363 363 363 364 289 288 289 387 365 363 363 364 289 288 289 289 289 390 289 289 289 289 289 298 299 299 299 244 245 299 299 299 299 299 299 299 300 296 387 388 389 289 362 363 364 289 289 289 289 289 362 363 364 289 
28 28 28 28 28 28 28 28 28 28 28 28 28 28 28 28 28 28 28 28 28 28 28 28 28 28 28 28 28 28 28 28 104 53 54 31 31 31 31 31 31 31 31 31 31 31 31 31 106 57 37 37 37 37 55 56 105 31 31 31 31 31 27 28 28 28 28 28 28 28 28 28 28 28 28 28 28 29 31 31 31 31 31 31 31 32 37 37 37 37 37 37 37 37 37 37 37 37 37 37 37 37 37 37 37 37 37 37 37 37 37 37 37 37 37 218 268 40 40 40 40 40 40 40 40 40 39 40 40 40 39 40 40 40 40 40 39 122 72 43 43 43 45 39 40 40 266 267 268 40 40 40 40 47 76 76 76 76 76 76 76 76 76 76 76 48 158 102 102 321 102 235 185 48 133 209 102 102 102 102 102 102 160 48 158 102 164 165 165 165 165 165 165 165 241 191 102 160 48 76 158 102 102 102 102 102 160 76 76 76 76 76 76 76 76 76 76 76 367 289 362 363 363 363 363 363 363 364 289 391 288 362 363 363 363 363 363 363 363 363 364 288 362 363 363 363 363 363 363 364 289 288 289 289 362 363 363 364 289 288 289 391 289 289 289 391 289 289 289 298 299 299 299 299 299 299 299 299 299 299 299 299 300 296 289 289 289 289 387 388 389 289 395 391 289 289 387 388 389 289 
28 28 28 28 28 28 28 28 28 28 28 28 28 28 28 28 28 28 28 28 28 28 28 28 28 28 28 28 28 104 53 53 54 31 31 31 31 31 31 31 31 31 31 31 31 31 31 106 57 37 37 37 37 37 37 37 30 31 31 31 31 31 52 53 103 28 28 28 28 28 28 28 28 28 28 28 28 29 31 31 31 31 31 31 31 32 37 37 37 37 37 37 37 37 37 37 37 37 37 37 37 37 37 37 37 37 37 37 37 37 37 37 37 37 37 37 293 40 40 40 40 40 40 40 40 40 39 40 40 40 39 40 40 40 40 40 39 47 43 43 43 43 45 39 40 40 291 292 293 40 40 40 122 72 76 76 76 76 76 76 76 76 76 76 76 48 158 102 321 102 102 160 23 98 158 102 320 102 102 102 322 102 160 48 158 102 164 165 165 165 165 165 165 241 191 102 102 160 48 76 183 234 102 102 102 102 160 76 76 76 76 76 76 76 76 76 76 76 367 289 289 365 363 363 363 363 363 364 289 289 288 362 363 363 363 363 363 363 363 363 364 288 362 363 363 363 363 363 363 364 289 288 289 289 340 363 363 364 289 288 289 289 289 395 289 289 289 289 289 298 299 299 219 220 299 299 219 220 299 299 299 299 300 296 289 289 289 289 289 289 289 289 289 289 289 289 289 289 289 289 
28 28 28 28 28 28 28 28 28 28 28 28 28 28 28 28 28 28 28 28 28 28 28 28 28 28 28 28 104 54 31 31 31 31 31 31 31 31 31 31 31 31 31 31 31 31 106 57 37 37 37 37 37 37 37 37 55 105 31 31 31 31 31 31 52 53 103 28 28 28 28 28 28 28 28 28 28 29 31 31 31 31 31 31 31 32 37 37 37 37 37 37 37 37 37 37 37 37 37 37 37 37 37 37 37 37 37 37 37 37 37 37 37 37 37 37 293 40 40 40 40 40 40 40 40 40 39 40 40 40 39 40 40 40 40 40 39 47 43 43 43 43 45 39 40 40 316 317 318 40 40 40 47 76 76 76 76 76 76 76 76 76 76 76 76 48 158 102 102 102 102 160 48 133 209 102 139 140 141 102 102 102 160 48 158 320 164 165 165 165 165 165 165 166 102 102 102 160 48 76 76 158 102 102 102 102 160 76 76 76 76 76 76 76 76 76 76 76 367 289 289 289 365 363 363 363 363 364 289 289 288 362 363 363 363 363 363 363 363 363 364 288 362 363 363 363 363 363 363 364 289 288 289 362 363 363 363 364 289 288 289 289 289 289 289 395 289 289 289 298 299 299 244 245 299 299 244 245 299 299 299 299 300 296 289 289 289 289 289 395 289 289 289 337 338 339 289 289 289 289 
28 28 28 28 28 28 28 28 28 28 28 28 28 28 28 28 28 28 28 28 28 28 28 28 28 28 28 28 29 31 31 31 31 31 31 31 31 31 31 31 31 31 31 31 31 106 57 37 37 37 37 37 37 37 37 37 37 55 105 31 31 31 31 31 31 31 52 103 28 28 28 28 28 28 28 28 28 29 31 31 31 31 31 31 31 32 37 37 37 37 37 37 37 37 37 37 37 37 37 37 37 37 37 37 37 37 37 37 37 37 37 37 37 37 37 37 218 268 40 40 40 40 40 40 40 40 39 40 40 40 39 40 40 40 40 40 39 47 43 43 43 20 96 39 40 40 40 40 40 40 40 40 47 76 76 76 76 76 76 76 76 76 76 76 23 98 158 102 102 320 102 160 48 158 102 102 164 165 166 102 102 102 160 48 158 102 189 190 240 165 165 165 241 191 102 320 102 160 48 76 76 183 184 184 184 184 185 76 76 76 76 76 76 76 76 76 76 76 392 153 289 390 289 388 388 388 388 389 289 289 288 362 363 363 363 363 363 363 363 363 364 288 362 363 363 363 363 363 363 364 289 288 289 362 363 363 363 364 289 288 289 395 390 289 289 289 395 289 289 298 299 299 299 299 299 299 299 299 299 219 220 299 300 296 337 338 339 289 289 391 289 289 289 362 363 364 289 289 395 289 
28 28 28 28 28 28 28 28 28 28 28 28 28 28 28 28 28 28 28 28 28 28 28 28 28 28 28 104 54 31 31 31 31 31 31 31 31 31 31 31 31 31 31 31 31 32 37 37 37 37 37 37 37 37 37 37 37 37 55 105 31 31 31 31 31 31 31 27 28 28 28 28 28 28 28 28 28 29 31 31 31 31 31 31 31 32 37 37 37 37 37 37 37 37 37 37 37 37 37 37 37 37 37 37 37 37 37 37 37 37 37 37 37 37 37 37 37 293 40 40 40 40 40 40 40 40 39 40 40 40 39 40 40 40 40 40 39 97 21 21 21 96 14 90 40 40 40 40 40 40 40 40 47 76 76 76 76 76 76 76 76 76 76 23 98 133 209 102 102 102 102 160 48 158 102 102 189 190 191 102 102 102 160 48 158 102 320 102 189 190 190 190 191 102 102 102 102 160 48 76 76 76 76 76 76 76 76 76 76 76 76 76 76 76 76 76 76 76 76 367 289 289 289 289 289 289 289 289 391 289 288 362 363 363 363 363 363 363 363 363 364 288 362 363 363 363 363 363 363 364 289 288 289 362 363 363 363 364 289 288 289 289 289 289 391 289 289 289 289 298 219 220 299 299 299 299 299 299 299 244 245 299 300 296 362 363 364 289 289 289 289 289 289 387 388 389 289 289 289 289
