20x20.bmp 300:24
283 283 283 189 240 165 165 165 165 165 165 165 165 165 165 165 165 165 165 165 165 165 241 191 283 189 240 165 165 165 165 165 165 165 165 165 165 165 165 241 191 283 283 283 283 283 283 283 283 283 283 283 130 82 156 156 156 156 156 156 270 156 156 156 156 156 156 156 156 156 156 108 182 283 283 283 335 283 283 283 283 251 34 34 34 34 34 34 34 34 34 34 34 34 34 34 34 34 5 80 31 31 31 31 31 31 31 31 31 31 31 31 31 31 31 31 31 31 31 31 31 31 31 31 31 31 31 31 31 2 78 28 28 28 28 28 28 28 28 28 28 28 28 28 28 28 28 28 28 28 28 28 28 28 28 28 28 28 28 28 28 28 28 28 28 28 28 28 28 28 28 28 28 28 29 31 31 31 31 31 31 31 31 31 31 31 31 31 31 31 31 31 31 31 31 31 31 31 31 31 2 78 28 28 28 28 28 28 28 28 28 28 28 28 28 28 28 28 28 28 28 28 28 28 28 28 28 28 28 28 28 28 28 28 28 28 28 28 28 28 104 54 31 31 31 31 31 31 31 31 31 31 31 31 81 7 34 34 34 34 34 34 34 34 34 34 202 278 102 102 102 102 102 380 381 381 381 381 381 381 381 381 381 382 102 102 102 139 140 215 165 165 165 165 165 165 165 165 165 165 
141 334 283 283 164 165 165 165 165 165 165 165 165 165 165 165 165 165 165 165 241 190 191 283 283 283 189 240 165 165 165 165 165 165 165 165 165 241 190 191 283 283 283 283 283 283 283 283 283 283 321 283 155 156 156 156 156 270 156 156 156 156 156 156 156 156 156 156 156 156 108 182 283 283 283 283 283 283 283 226 227 176 34 34 34 34 34 34 34 34 34 34 34 34 34 34 34 5 80 31 31 31 31 31 31 31 31 31 31 31 31 31 31 31 31 31 31 31 31 31 31 31 31 31 31 31 31 31 2 78 28 28 28 28 28 28 28 28 28 28 28 28 28 28 28 28 28 28 28 28 28 28 28 28 28 28 28 28 28 28 28 28 28 28 28 28 28 28 28 28 28 28 28 28 79 4 31 31 31 31 31 31 31 31 31 31 31 31 31 31 31 31 31 31 31 31 31 31 31 2 78 28 28 28 28 28 28 28 28 28 28 28 28 28 28 28 28 28 28 28 28 28 28 28 28 28 28 28 28 28 28 28 28 28 28 28 28 28 104 53 54 31 31 31 31 31 31 31 31 31 31 31 31 31 31 32 34 34 34 34 34 34 34 34 34 202 278 102 102 102 335 102 102 102 102 102 102 102 102 102 102 102 102 102 102 139 140 215 165 165 165 165 165 165 165 165 165 165 165 165 
216 140 141 283 189 240 165 165 165 165 165 165 165 165 165 165 165 165 165 165 166 283 283 283 334 283 283 189 240 165 165 165 165 165 165 241 190 191 283 283 283 283 283 333 283 283 283 283 283 283 283 283 155 156 156 156 156 156 156 156 156 156 156 156 156 156 156 156 108 181 182 283 283 283 283 283 283 283 226 176 34 34 34 34 34 34 34 34 34 34 34 34 34 34 34 34 5 80 31 31 31 31 31 31 31 31 31 31 31 31 31 31 31 31 31 31 31 31 31 31 31 31 31 31 31 31 31 2 78 28 28 28 28 28 28 28 28 28 28 28 28 28 28 28 28 28 28 28 28 28 28 28 28 28 28 28 28 28 28 28 28 28 28 28 28 28 28 28 28 28 28 28 28 28 28 79 4 31 31 31 31 31 31 31 31 31 31 31 31 31 31 31 31 31 31 31 31 31 2 78 28 28 28 28 28 28 28 28 28 28 28 28 28 28 28 28 28 28 28 28 28 28 28 28 28 28 28 28 28 28 28 28 28 28 28 28 104 53 54 31 31 31 31 31 31 31 31 31 31 31 31 31 31 31 31 32 34 34 34 34 34 34 34 34 34 253 102 102 102 102 102 102 102 102 102 102 102 102 102 102 102 102 102 139 140 215 165 165 165 165 165 165 165 165 165 165 165 165 165 165 
165 165 216 140 141 189 240 165 165 165 165 165 165 165 165 165 165 165 165 165 216 141 283 283 283 283 283 283 189 190 190 190 190 190 190 191 283 283 283 283 283 283 283 283 283 283 283 335 283 283 283 283 155 156 156 156 156 156 156 156 156 156 270 156 156 156 295 108 182 283 283 283 283 283 283 283 226 227 176 34 34 34 34 34 34 34 34 34 34 34 34 34 34 34 34 5 80 31 31 31 31 31 31 31 31 31 31 31 31 31 31 31 31 31 31 31 31 31 31 31 31 31 31 31 31 31 2 78 28 28 28 28 28 28 28 28 28 28 28 28 28 28 28 28 28 28 28 28 28 28 28 28 28 28 28 28 28 28 28 28 28 28 28 28 28 28 28 28 28 28 28 28 28 28 28 28 79 3 4 31 2 3 3 3 3 4 31 31 31 31 31 31 31 31 31 31 31 2 78 28 28 28 28 28 28 28 28 28 28 28 28 28 28 28 28 28 28 28 28 28 28 28 28 28 28 28 28 28 28 28 28 28 28 28 104 53 54 31 31 31 31 31 31 31 31 31 31 31 31 31 31 31 31 106 56 57 34 34 34 34 34 34 34 34 202 278 102 102 385 386 102 102 102 336 102 102 102 102 102 102 139 140 140 215 165 165 165 165 165 165 165 165 165 165 165 165 165 165 165 165 
165 165 165 165 216 141 189 240 165 165 165 165 165 165 165 165 165 165 165 165 165 216 141 283 283 283 283 283 283 283 283 283 283 283 283 283 283 283 283 283 283 283 283 283 283 283 283 283 283 283 283 322 180 107 156 156 156 156 295 156 156 156 156 156 156 156 108 182 283 283 283 283 336 283 283 226 176 34 34 34 34 34 34 34 34 34 34 34 34 34 34 34 34 34 5 80 31 31 31 31 31 31 31 31 31 31 31 31 31 31 31 31 31 31 31 31 31 31 31 31 31 31 31 31 31 2 78 28 28 28 28 28 28 28 28 28 28 28 28 28 28 28 28 28 28 28 28 28 28 28 28 28 28 28 28 28 28 28 28 28 28 28 28 28 28 28 28 28 28 28 28 28 28 28 28 28 28 28 79 3 78 28 28 28 28 79 3 3 4 31 31 31 31 31 31 31 2 78 28 28 28 28 28 28 28 28 28 104 53 53 53 103 28 28 28 28 28 28 28 28 28 28 28 28 28 28 28 28 28 28 28 28 104 53 54 31 31 31 31 31 31 31 31 31 31 31 31 31 31 31 31 31 106 57 34 34 34 34 34 34 34 34 34 202 278 102 102 102 302 304 102 102 102 102 102 102 102 102 139 140 215 165 165 165 165 165 165 165 165 165 165 165 165 165 165 165 165 165 165 165 
165 165 165 165 165 166 283 189 240 165 165 165 165 165 165 165 165 165 165 165 165 165 216 141 283 283 283 283 283 283 283 283 283 283 283 283 283 283 283 334 283 283 283 283 283 283 139 140 140 140 141 283 283 180 107 156 156 156 156 156 156 156 156 156 156 108 182 283 283 283 283 283 283 283 226 176 34 34 34 34 34 34 34 34 34 34 34 34 34 34 34 34 34 5 80 31 31 31 31 31 31 31 31 31 31 31 31 31 31 31 31 31 31 31 31 31 31 31 31 31 31 31 31 31 2 78 28 28 28 28 28 28 28 28 28 28 28 28 28 28 28 28 28 28 28 28 28 28 28 28 28 28 28 28 28 28 28 28 28 28 28 28 28 28 28 28 28 28 28 28 28 28 28 28 28 28 28 28 28 28 28 28 28 28 28 28 28 28 79 3 3 3 3 3 3 3 78 28 28 28 28 28 28 28 28 28 104 54 31 31 31 52 103 28 28 28 28 28 28 28 28 28 28 28 28 28 28 28 28 28 104 53 54 31 31 31 31 31 31 31 31 31 31 31 31 31 31 31 31 31 31 106 57 34 34 34 34 34 34 34 34 34 202 278 102 102 102 102 376 378 102 102 102 102 102 102 102 139 215 165 165 165 165 165 165 165 165 165 165 165 165 165 165 165 165 165 165 165 165 165 
165 165 165 165 165 216 141 283 189 240 165 165 165 165 165 165 165 165 165 165 165 165 165 216 140 140 141 139 140 140 140 141 283 283 283 283 283 283 283 283 283 283 283 283 283 139 215 165 165 165 166 283 283 283 180 181 107 156 156 156 156 156 156 108 181 182 283 283 283 283 283 283 283 226 176 34 34 34 34 34 34 34 34 34 34 34 34 34 34 34 34 34 5 80 31 31 31 31 31 31 31 31 31 31 31 31 31 31 31 31 31 31 31 31 31 31 31 31 31 31 31 31 31 2 78 28 28 28 28 28 28 28 28 28 28 28 28 28 28 28 28 28 28 28 28 28 28 28 28 28 28 28 28 28 28 28 28 28 28 28 28 28 28 28 28 28 28 28 28 28 28 28 28 28 28 28 28 28 28 28 28 28 28 28 28 28 28 28 28 28 28 28 28 28 28 28 28 28 28 28 28 28 28 28 28 28 29 31 31 31 31 31 52 103 28 28 28 28 28 28 28 28 28 28 28 28 28 28 28 104 54 31 31 31 31 31 31 31 31 31 31 31 31 31 31 31 31 31 31 31 31 32 34 34 34 34 34 34 34 34 34 202 278 102 102 102 102 102 302 304 102 102 102 102 102 139 140 215 165 165 165 165 165 165 165 165 165 165 165 165 165 165 165 165 165 165 165 165 165 165 
165 165 165 165 165 165 216 141 283 189 240 165 165 165 165 165 165 165 165 165 165 165 165 165 165 165 216 215 165 165 165 216 140 140 141 283 283 283 283 283 283 283 283 283 139 215 165 165 165 165 216 141 321 283 283 283 180 181 181 181 181 181 181 182 283 283 283 283 283 283 283 226 227 176 34 34 34 34 34 34 34 34 34 34 34 34 34 34 34 34 34 34 30 31 31 31 31 31 31 31 31 31 31 31 31 31 31 31 31 31 31 31 31 31 31 31 31 31 31 31 31 31 2 78 28 28 28 28 28 28 28 28 28 28 28 28 28 28 28 28 28 28 28 28 28 28 28 28 28 28 28 28 28 28 28 28 28 28 28 28 28 28 28 28 28 28 28 28 28 28 28 28 28 28 28 28 28 28 28 28 28 28 28 28 28 28 28 28 28 28 28 28 28 28 28 28 28 28 28 28 28 28 28 28 28 28 29 31 31 31 31 31 31 52 103 28 28 28 28 28 28 28 28 28 28 28 28 104 53 54 31 31 31 31 31 31 31 31 31 31 31 31 31 31 31 31 31 31 31 31 31 81 7 34 34 34 34 34 34 34 34 253 102 102 102 102 102 102 376 378 102 102 102 102 139 215 165 165 165 165 165 165 165 165 165 165 165 165 165 165 165 165 165 165 165 165 165 165 165 165 
165 165 165 165 165 165 165 216 141 283 189 240 165 165 165 165 165 165 165 165 165 165 165 165 165 165 165 165 165 165 165 165 165 165 216 141 283 283 283 283 283 283 283 139 215 165 165 165 165 165 165 166 283 283 283 283 283 283 283 283 283 283 283 283 283 283 283 336 283 283 226 176 34 34 34 34 34 34 34 34 34 34 34 34 34 34 34 34 34 34 34 5 80 31 31 31 31 31 31 31 31 31 31 31 31 31 31 31 31 31 31 31 31 31 31 31 31 31 31 31 31 31 27 28 28 28 28 28 28 28 28 28 28 28 28 28 28 28 28 28 28 28 28 28 28 28 28 28 28 28 28 28 28 28 28 28 28 28 28 28 28 28 28 28 28 28 28 28 28 28 28 28 28 28 28 28 28 28 28 28 28 28 28 28 28 28 28 28 28 28 28 28 28 28 28 28 28 28 28 28 28 28 28 28 28 28 79 4 31 31 31 31 31 31 52 103 28 28 28 28 28 28 28 28 28 28 104 54 31 31 31 31 31 31 31 31 31 31 31 31 31 31 31 31 31 31 31 31 31 31 31 31 32 34 34 34 34 34 34 34 202 278 102 102 102 102 102 102 302 304 102 102 102 139 215 165 165 165 165 165 165 165 165 165 165 165 165 165 165 165 165 165 165 165 165 165 165 165 165 165 
165 165 165 165 165 165 165 165 166 283 283 189 240 165 165 165 165 165 165 165 165 165 165 165 165 165 165 165 165 165 165 165 165 165 165 166 283 283 283 283 283 283 139 215 165 165 165 165 165 165 165 216 141 283 283 359 329 301 329 301 329 301 329 301 329 358 283 283 283 226 176 34 34 34 34 34 34 34 34 34 34 34 34 34 34 34 34 34 34 34 34 30 31 31 31 31 31 31 31 31 31 31 31 31 31 31 31 31 31 31 31 31 31 31 31 31 31 31 31 31 31 31 52 103 28 28 28 28 28 28 28 28 28 28 28 28 28 28 28 28 28 28 28 28 28 28 28 28 28 28 28 28 28 28 28 28 28 28 28 28 28 28 28 28 28 28 28 28 28 28 28 28 28 28 28 28 28 28 28 28 28 28 28 28 28 28 28 28 28 28 28 28 28 28 28 28 28 28 28 28 28 28 28 28 28 28 28 29 31 31 31 31 31 31 31 52 103 28 28 28 28 28 28 28 28 104 54 31 31 31 31 31 31 31 31 31 31 31 31 31 31 31 31 31 31 31 31 31 31 31 31 31 32 34 34 34 34 34 34 34 253 102 102 102 102 335 102 102 376 378 102 102 102 164 165 165 165 165 165 165 165 165 165 165 165 165 165 165 165 165 165 165 165 165 165 165 165 165 165 165 
165 165 165 165 165 165 165 165 216 141 283 283 189 240 165 165 165 165 165 165 165 165 165 165 165 165 165 165 165 165 165 165 165 165 165 166 283 283 283 333 283 139 215 165 165 165 165 165 165 165 165 165 216 141 283 384 379 351 379 351 379 351 379 351 379 383 283 283 226 176 34 34 34 34 34 34 34 34 34 34 34 34 34 34 34 34 34 34 34 34 34 30 31 31 31 31 31 31 31 31 31 31 31 31 31 31 31 31 31 31 31 31 31 31 31 31 31 31 31 31 31 31 31 52 103 28 28 28 28 28 28 28 28 28 28 28 28 28 28 28 28 28 28 28 28 28 28 28 28 28 28 28 28 28 28 28 28 28 28 28 28 28 28 28 28 28 28 28 28 28 28 28 28 28 28 28 28 28 28 28 28 28 28 28 28 28 28 28 28 28 28 28 28 28 28 28 28 28 28 28 28 28 28 28 28 28 28 29 31 31 31 31 31 31 31 31 52 53 103 28 28 28 28 104 53 54 31 31 31 31 31 31 31 31 31 31 31 31 31 31 31 31 31 31 31 31 31 31 31 31 31 31 32 34 34 34 34 34 34 202 278 102 102 102 102 102 102 102 302 304 102 102 139 215 165 165 165 165 165 165 165 165 165 165 165 165 165 165 165 165 165 165 165 165 165 165 165 165 165 165 
165 165 165 165 165 165 165 165 165 166 283 333 283 189 240 165 165 165 165 165 165 165 165 165 165 165 165 165 165 165 165 165 165 165 165 166 283 283 283 283 283 164 165 165 165 165 165 165 165 165 165 165 165 166 283 283 283 283 283 283 283 283 283 283 283 283 283 226 176 34 34 34 34 34 34 34 34 34 34 34 34 34 34 34 34 34 34 34 34 34 34 30 31 31 31 31 31 31 31 31 31 31 31 31 31 31 31 31 31 31 31 31 31 31 31 31 31 31 31 31 31 31 31 31 52 53 53 53 53 53 103 28 28 28 28 28 28 28 28 28 28 28 28 28 28 28 28 28 28 28 28 28 28 28 28 28 28 28 28 28 28 28 28 28 28 28 28 28 28 28 28 28 28 28 28 28 28 28 28 28 28 28 28 28 28 28 28 28 28 28 28 28 28 28 28 28 28 28 28 28 28 28 28 28 28 28 28 79 4 31 31 31 31 31 31 31 31 31 52 53 53 53 53 54 31 31 31 31 31 31 31 31 31 31 31 31 31 31 31 31 31 31 31 31 31 31 31 31 31 31 31 106 57 34 34 34 34 34 34 253 102 102 102 102 102 102 102 102 360 361 102 139 215 165 165 165 165 165 165 165 165 165 165 165 165 165 165 165 165 165 165 165 165 165 165 165 165 165 165 165 
165 165 165 165 165 165 165 165 165 216 141 283 283 283 189 240 165 165 165 165 165 165 165 165 165 165 165 165 165 165 165 165 165 165 165 166 283 283 283 283 139 215 165 165 165 165 165 165 165 165 165 165 165 166 283 359 301 329 301 329 301 329 301 329 301 358 283 251 34 34 34 34 34 34 34 34 34 34 34 34 34 34 34 34 34 34 34 34 34 34 34 30 31 31 31 31 31 31 31 31 31 31 31 31 31 31 31 31 31 31 31 31 31 31 31 31 31 31 31 31 31 31 31 31 31 31 31 31 31 31 52 103 28 28 28 28 28 28 28 28 28 28 28 28 28 28 28 28 28 28 28 28 28 28 28 28 28 28 28 28 28 28 28 28 28 28 28 28 28 28 28 28 28 28 28 28 28 28 28 28 28 28 28 28 28 28 28 28 28 28 28 28 28 28 28 28 28 28 28 28 28 28 28 28 28 28 28 28 79 3 3 3 4 31 31 31 31 31 31 31 31 31 31 31 31 31 31 31 31 31 31 31 31 31 31 31 31 31 31 31 31 31 31 31 31 31 31 31 31 31 106 57 34 34 34 34 34 34 202 278 102 102 102 102 102 102 102 102 102 102 102 164 165 165 165 165 165 165 165 165 165 165 165 165 165 165 165 165 165 165 165 165 165 165 165 165 165 165 165 165 
165 165 165 165 165 165 165 165 165 165 216 141 283 283 283 189 240 165 165 165 165 165 165 165 165 165 165 165 165 165 165 165 165 165 165 166 283 283 283 283 164 165 165 165 165 165 165 165 165 165 165 165 165 166 283 384 351 379 351 379 351 379 351 379 351 383 226 176 34 34 34 34 34 34 34 34 34 34 34 34 34 34 34 34 34 34 34 34 34 34 34 30 31 31 31 31 31 31 31 31 31 31 31 31 31 31 31 31 31 31 31 31 31 31 31 31 31 31 31 31 31 31 31 31 31 31 31 31 31 31 31 27 28 28 28 28 28 28 28 28 28 28 28 28 28 28 28 28 28 28 28 28 28 28 104 53 53 53 53 53 53 53 53 53 53 53 53 53 53 53 53 103 28 28 28 28 28 28 28 28 28 28 28 28 28 28 28 28 28 28 28 28 28 28 28 28 28 28 28 28 28 28 28 28 28 28 28 28 28 28 28 28 79 3 3 4 31 31 31 31 31 31 31 31 31 31 31 31 31 31 31 31 31 31 31 31 31 31 31 31 31 31 31 31 31 31 31 31 31 106 57 34 34 34 34 34 34 202 278 102 102 102 102 102 102 102 102 102 102 102 139 215 165 165 165 165 165 165 165 165 165 165 165 165 165 165 165 165 165 165 165 165 165 165 165 165 165 165 165 165 
165 165 165 165 165 165 165 165 165 165 165 216 140 140 141 283 189 240 165 165 165 165 165 165 165 165 165 165 165 165 165 165 165 165 165 166 283 283 283 283 164 165 165 165 165 165 165 165 165 165 165 165 165 166 283 283 283 283 283 283 283 283 283 283 283 283 251 34 34 34 34 34 34 34 34 34 34 34 34 34 34 34 34 34 34 34 34 34 34 34 34 30 31 31 31 31 31 31 31 31 31 31 31 31 31 31 31 31 31 31 31 31 31 31 31 31 31 31 31 31 31 31 31 31 31 31 31 31 31 31 31 27 28 28 28 28 28 28 28 28 28 28 28 28 28 28 28 28 28 28 28 28 104 53 54 31 31 31 31 31 31 31 31 31 31 31 31 31 31 31 31 52 53 103 28 28 28 28 28 28 28 28 28 28 28 28 28 28 28 28 28 28 28 28 28 28 28 28 28 28 28 28 28 28 28 28 28 28 28 28 28 28 28 28 28 79 4 31 31 31 31 31 31 31 31 31 31 31 31 31 31 31 31 31 31 31 31 31 31 31 31 31 31 31 31 31 31 31 106 57 34 34 34 34 34 34 202 278 102 102 102 102 102 102 102 102 102 102 102 102 164 165 165 165 165 165 165 165 165 165 165 165 165 165 165 165 165 165 165 165 165 165 165 165 165 165 165 165 165 165 
165 165 165 165 165 165 165 165 165 165 165 165 165 165 216 140 141 189 190 240 165 165 165 165 165 165 165 165 165 165 165 165 165 241 190 191 283 283 283 283 189 240 165 165 165 165 165 165 165 165 165 165 241 191 283 359 329 301 329 301 329 301 329 301 329 358 251 34 34 34 34 34 34 34 34 34 34 34 34 34 34 34 34 34 34 34 34 34 34 34 34 30 31 31 31 31 31 31 31 31 31 31 31 31 31 31 31 31 31 31 31 31 31 31 31 31 31 31 31 31 31 31 31 31 31 31 31 31 31 31 31 27 28 28 28 28 28 28 28 28 28 28 28 28 28 28 28 28 28 28 28 28 29 31 31 31 31 31 31 31 31 31 31 31 31 31 31 31 31 31 31 31 31 52 103 28 28 28 28 28 28 28 28 28 28 28 28 28 28 28 28 28 28 28 28 28 28 28 28 28 28 28 28 28 28 28 28 28 28 28 28 28 28 28 28 28 29 31 31 31 31 31 31 31 31 31 31 31 31 31 31 31 31 31 31 31 31 31 31 31 31 31 31 31 31 31 31 106 57 34 34 34 34 34 34 34 253 102 102 102 102 102 102 102 102 102 102 102 102 139 215 165 165 165 165 165 165 165 165 165 165 165 165 165 165 165 165 165 165 165 165 165 165 165 165 165 165 165 165 165 
165 165 165 165 165 165 165 165 165 165 165 165 165 165 165 165 216 140 141 189 190 190 190 190 190 190 190 190 190 190 190 190 190 191 283 283 283 283 283 283 283 189 240 165 165 165 165 165 165 165 165 241 191 283 283 384 379 351 379 351 379 351 379 351 379 383 276 201 34 34 34 34 34 34 34 34 34 34 34 34 34 34 34 34 34 34 34 34 34 34 34 30 31 31 31 31 31 31 31 31 31 31 31 31 31 31 31 31 31 31 31 31 31 31 31 31 31 31 31 31 31 31 31 31 31 31 31 31 31 31 31 27 28 28 28 28 28 28 28 28 28 28 28 28 28 28 28 28 28 28 28 104 54 31 31 31 31 31 31 31 106 56 56 56 56 56 56 56 105 31 31 31 31 31 52 103 28 28 28 28 28 28 28 28 28 28 28 28 28 28 28 28 28 28 28 28 28 28 28 28 28 28 28 28 28 28 28 28 28 28 28 28 28 28 28 28 29 31 31 31 31 31 31 31 31 31 31 31 31 31 31 31 31 31 31 31 31 31 31 31 31 31 31 31 31 31 31 32 34 34 34 34 34 34 34 202 278 102 102 102 102 102 336 102 102 102 102 102 139 215 165 165 165 165 165 165 165 165 165 165 165 165 165 165 165 165 165 165 165 165 165 165 165 165 165 165 165 165 165 165 
165 165 165 165 165 165 165 165 165 165 165 165 165 165 165 165 165 165 216 140 140 140 140 141 283 283 283 283 283 283 283 283 283 283 283 283 283 283 283 283 283 283 189 190 190 190 190 190 190 190 190 191 283 283 283 283 283 283 283 283 283 283 283 283 283 283 283 251 34 34 34 34 34 34 34 34 34 34 34 34 34 34 34 34 34 34 34 34 34 34 34 30 31 31 31 31 31 31 31 31 31 31 31 31 31 31 31 31 31 31 31 31 31 31 31 31 31 31 31 31 31 31 31 31 31 31 31 31 31 31 2 78 28 28 28 28 28 28 28 28 28 28 28 28 28 28 28 28 28 28 28 29 31 31 31 31 31 106 56 56 57 34 34 34 34 34 34 34 55 56 105 31 31 31 31 52 103 28 28 28 28 28 28 28 28 28 28 28 28 28 28 28 28 28 28 28 28 28 28 28 28 28 28 28 28 28 28 28 28 28 28 28 28 28 28 104 54 31 31 31 31 31 31 31 31 31 31 31 31 31 31 31 31 31 31 31 31 31 31 31 31 31 31 31 31 31 31 32 34 34 34 34 34 34 34 253 102 102 102 102 102 102 102 102 102 102 102 102 164 165 165 165 165 165 165 165 165 165 165 165 165 165 165 165 165 165 165 165 165 165 165 165 165 165 165 165 165 165 165 165 
165 165 165 165 165 165 165 165 165 165 165 165 165 165 165 165 165 165 165 165 165 165 165 216 140 141 283 283 283 283 283 283 283 335 283 283 283 283 283 283 283 283 283 283 283 283 283 283 283 283 336 283 283 283 283 359 301 329 301 329 301 329 301 329 301 358 283 251 34 34 34 34 34 34 34 34 34 34 34 34 34 34 34 34 34 34 34 34 34 34 34 30 31 31 31 31 31 31 31 31 31 31 31 31 31 31 31 31 31 31 31 31 31 31 31 31 31 31 31 31 31 31 31 31 31 31 31 2 3 3 78 28 28 28 28 28 28 28 28 28 28 28 28 28 28 28 28 28 28 28 28 29 31 31 31 31 106 57 34 34 34 34 34 34 34 34 34 34 34 34 30 31 31 31 31 31 52 103 28 28 28 28 28 28 28 28 28 28 28 28 28 28 28 28 28 28 28 28 28 28 28 28 28 28 28 28 28 28 28 28 28 104 53 53 53 54 31 31 31 31 31 31 31 31 31 31 31 31 31 31 31 31 31 31 31 31 31 31 31 31 31 31 31 31 31 31 31 81 7 34 34 34 34 34 202 278 102 102 102 102 102 102 102 102 102 102 139 140 215 165 165 165 165 165 165 165 165 165 165 165 165 165 165 165 165 165 165 165 165 165 165 165 165 165 165 165 165 165 165 165 
165 165 165 165 165 165 165 165 165 165 165 165 165 165 165 165 165 165 165 165 165 165 165 165 165 216 140 141 283 283 283 283 283 283 283 283 283 333 139 140 140 140 140 140 140 140 140 140 140 141 283 283 283 283 283 384 351 379 351 379 351 379 351 379 351 383 283 276 201 34 34 34 34 34 34 34 34 34 34 34 34 34 34 34 34 34 34 34 34 34 34 55 105 31 31 31 31 31 31 31 31 31 31 31 31 31 31 31 31 31 31 31 31 31 31 31 31 31 31 31 31 31 31 31 31 2 3 78 28 28 28 28 28 28 28 28 28 28 28 28 28 28 28 28 28 28 28 28 28 28 28 29 31 31 31 106 57 34 34 34 34 34 34 34 34 34 34 34 34 34 55 105 31 31 31 31 31 52 103 28 28 28 28 28 28 28 28 28 28 28 28 28 28 28 28 28 28 28 28 28 28 28 28 28 28 28 28 28 28 104 53 54 31 31 31 31 31 31 31 31 31 31 31 31 31 31 31 31 31 31 31 31 31 31 31 31 31 31 31 31 31 31 31 31 31 31 31 31 32 34 34 34 34 34 253 102 102 102 102 102 102 102 102 102 102 102 164 165 165 165 165 165 165 165 165 165 165 165 165 165 165 165 165 165 165 165 165 165 165 165 165 165 165 165 165 165 165 165 165 165 
165 165 165 165 165 165 165 165 165 165 165 165 165 165 165 165 165 165 165 165 165 165 165 165 165 165 165 216 140 141 283 283 283 283 283 283 139 140 215 165 165 165 165 165 165 165 165 165 165 216 140 141 283 283 283 283 283 283 283 283 283 283 283 283 283 283 283 283 251 34 34 34 34 34 34 34 34 34 34 34 34 34 34 34 34 34 34 34 34 34 34 34 30 31 31 31 31 31 31 31 31 31 31 31 31 31 31 31 31 31 31 31 31 31 31 31 31 31 31 31 31 31 31 31 31 27 28 28 28 28 28 28 28 28 28 28 28 28 28 28 28 28 28 28 28 28 28 28 28 28 28 29 31 31 31 32 34 34 34 34 34 34 34 34 34 34 34 34 34 34 34 55 105 31 31 31 31 31 27 28 28 28 28 28 28 28 28 28 28 28 28 28 28 28 28 28 28 28 28 28 28 28 28 28 28 28 28 104 53 54 31 31 31 31 31 31 31 31 31 31 31 31 31 31 31 31 31 31 31 31 31 31 31 31 31 31 31 31 31 31 31 31 31 31 31 31 31 31 81 7 34 34 34 202 278 102 102 102 102 335 102 102 102 102 139 140 215 165 165 165 165 165 165 165 165 165 165 165 165 165 165 165 165 165 165 165 165 165 165 165 165 165 165 165 165 165 165 165 165 165 
165 165 165 165 165 165 165 165 165 165 165 165 165 165 165 165 165 165 165 165 165 165 165 165 165 165 165 165 165 216 140 140 140 140 140 140 215 165 165 165 165 165 165 165 165 165 165 165 165 165 165 216 141 283 283 359 329 301 329 301 329 301 329 301 329 358 283 283 276 201 34 34 34 34 34 34 34 34 34 34 34 34 34 34 34 34 34 34 34 34 34 34 30 31 31 31 31 31 31 31 31 31 31 31 31 31 31 31 31 31 31 31 31 31 31 31 31 31 31 31 31 31 31 31 2 78 28 28 28 28 28 28 28 28 28 28 28 28 28 28 28 28 28 28 28 28 28 28 28 28 28 79 4 31 31 32 34 34 34 202 277 277 277 277 277 277 201 34 34 34 34 34 55 105 31 31 31 31 52 103 28 28 28 28 28 28 28 28 28 28 28 28 28 28 28 28 28 28 28 28 28 28 28 28 28 104 53 54 31 31 31 31 31 31 31 31 31 31 31 31 31 31 31 31 31 31 31 31 31 31 31 31 31 31 31 31 31 31 31 31 31 31 31 31 31 31 31 31 31 32 34 34 34 253 102 102 102 102 102 102 102 102 102 102 164 165 165 165 165 165 165 165 165 165 165 165 165 165 165 165 165 165 165 165 165 165 165 165 165 165 165 165 165 165 165 165 165 165 165 165 
165 165 165 165 165 165 165 165 165 165 165 165 165 165 165 165 165 165 165 165 165 165 165 165 165 165 165 165 165 165 165 165 165 165 165 165 165 165 165 165 165 165 165 165 165 165 165 165 165 165 165 165 216 141 283 384 379 351 379 351 379 351 379 351 379 383 283 283 283 251 34 34 34 34 34 34 34 34 34 34 34 34 34 34 34 34 34 34 34 34 34 34 30 31 31 31 31 31 31 31 31 31 31 31 31 31 31 31 31 31 31 31 31 31 31 31 31 31 31 31 31 31 31 2 78 28 28 28 28 28 28 28 28 28 28 28 28 28 28 28 28 28 28 28 28 28 28 28 28 28 28 28 29 31 31 32 34 34 202 278 139 140 140 140 140 141 276 201 34 34 34 34 34 55 105 31 31 31 31 52 53 103 28 28 28 28 28 28 28 28 28 28 28 28 28 28 28 28 28 28 28 28 28 28 104 54 31 31 31 31 31 31 31 31 31 31 31 31 31 31 31 31 31 31 31 31 31 31 31 31 31 31 31 31 31 31 31 31 31 31 31 31 31 31 31 31 31 31 106 57 34 34 34 253 102 102 102 102 102 102 102 102 102 139 215 165 165 165 165 165 165 165 165 165 165 165 165 165 165 165 165 165 165 165 165 165 165 165 165 165 165 165 165 165 165 165 165 165 165 165 
165 165 165 165 165 165 165 165 165 165 165 165 165 165 165 165 165 165 165 165 165 165 165 165 165 165 165 165 165 165 165 165 165 165 165 165 165 165 165 165 165 165 165 165 165 165 165 165 165 165 165 165 165 166 283 283 283 283 283 283 283 283 283 283 283 283 283 283 283 276 201 34 34 34 34 34 34 34 34 34 34 34 34 34 34 34 34 34 34 34 34 34 55 105 31 31 31 31 31 31 31 31 31 31 31 31 31 31 31 31 31 31 31 31 31 31 31 31 31 31 31 31 31 27 28 28 28 28 28 28 28 28 28 28 28 28 28 28 28 28 28 28 28 28 28 28 28 28 28 28 28 104 54 31 31 32 34 34 253 283 164 165 165 165 165 216 141 276 201 34 34 34 34 34 55 105 31 31 31 31 31 27 28 28 28 28 28 28 28 28 28 28 28 28 28 28 28 28 28 28 28 28 28 104 54 31 31 31 31 31 31 31 31 31 31 31 31 31 31 31 31 31 31 31 31 31 31 31 31 31 31 31 31 31 31 31 31 31 31 31 31 31 31 31 31 31 31 106 57 34 34 34 202 278 102 102 102 102 102 102 102 102 139 215 165 165 165 165 165 165 165 165 165 165 165 165 165 165 165 165 165 165 165 165 165 165 165 165 165 165 165 165 165 165 165 165 165 165 165 165
