20x20.bmp 200:24
363 363 363 363 363 363 363 363 363 363 363 363 364 289 289 289 289 289 369 76 76 76 76 158 102 102 189 190 191 102 102 102 102 164 165 166 102 102 307 308 308 308 308 309 102 102 102 251 292 292 253 102 102 102 102 102 322 102 102 102 102 102 102 102 102 102 102 102 102 102 102 102 102 102 322 102 102 102 139 215 165 165 165 165 165 165 165 165 165 165 165 165 165 165 165 165 165 165 165 165 165 165 165 165 165 165 165 165 165 165 165 165 216 102 141 102 102 102 102 102 164 165 166 102 102 102 102 139 141 139 215 216 141 102 102 102 102 251 292 292 292 292 292 292 292 292 292 292 292 292 292 292 292 292 292 292 292 292 292 292 292 292 292 292 292 292 5 80 31 31 31 31 31 31 31 31 31 31 31 31 31 31 31 31 31 31 31 31 31 31 31 31 27 28 28 28 28 28 28 28 
363 363 363 363 363 363 363 363 363 363 363 366 389 289 289 391 289 289 369 76 76 76 76 158 102 102 102 102 102 102 102 102 102 189 190 191 102 102 102 139 141 102 102 102 335 102 102 276 201 292 177 228 102 102 320 102 102 102 102 102 102 102 102 130 131 131 132 102 321 102 102 102 102 102 102 102 102 139 215 165 165 165 165 165 165 165 165 165 165 165 165 165 165 165 165 165 165 165 165 165 165 165 165 165 165 165 165 165 165 165 165 165 165 165 216 141 102 102 102 102 189 190 191 102 102 102 102 189 191 189 240 241 191 102 102 102 102 251 292 292 292 292 292 292 292 292 292 292 292 292 292 292 292 292 292 292 292 292 292 292 292 292 292 292 292 5 80 31 31 31 31 31 31 31 31 31 31 31 31 31 31 31 31 31 31 31 31 31 31 31 31 31 52 103 28 28 28 28 28 28 
363 363 363 363 363 363 363 363 363 363 366 389 289 289 289 289 289 289 369 76 76 76 76 158 102 102 102 102 102 102 102 102 335 102 102 102 102 102 102 189 191 102 102 102 102 102 102 102 251 292 292 177 228 102 102 102 102 102 102 102 102 130 131 82 156 156 83 132 102 102 102 102 102 102 102 102 139 215 165 165 165 165 165 165 165 165 165 165 165 165 165 165 165 165 165 165 165 165 165 165 165 165 165 165 165 165 165 165 165 165 165 165 165 165 165 216 102 141 102 139 141 102 102 102 102 102 102 102 102 102 189 191 102 102 102 102 226 176 292 292 292 292 292 292 292 292 292 292 292 292 292 292 292 292 292 292 292 292 292 292 292 292 292 292 5 80 31 31 31 31 31 31 31 31 31 31 31 31 31 31 31 31 31 31 31 31 31 31 31 31 31 31 31 27 28 28 28 28 28 28 
363 363 363 363 363 363 363 363 363 363 364 289 289 390 289 289 289 154 394 76 76 76 133 209 102 102 102 139 140 141 102 102 102 102 102 139 141 102 102 102 102 102 139 140 141 102 102 102 276 201 292 292 253 102 102 102 102 102 102 102 130 82 156 156 156 156 156 157 102 102 102 102 102 321 102 102 164 165 165 165 165 165 165 165 165 165 165 165 165 165 165 165 165 165 165 165 165 165 165 165 165 165 165 165 165 165 165 165 165 165 165 165 165 165 165 165 165 216 102 189 191 102 102 102 102 102 102 102 102 102 159 102 102 102 102 226 176 292 292 292 292 292 292 292 292 292 292 292 292 292 292 292 292 292 292 292 292 292 292 292 292 292 292 5 80 31 31 31 31 31 31 31 31 31 31 31 31 31 31 31 31 31 31 31 31 31 31 31 31 31 31 31 31 27 28 28 28 28 28 28 
363 363 363 363 363 363 363 363 363 366 389 289 289 289 289 289 289 369 76 76 76 76 158 102 102 322 102 164 165 166 102 102 102 102 139 215 216 141 102 102 102 102 164 165 166 102 139 141 102 276 201 292 253 102 322 102 320 102 102 102 155 156 156 295 156 156 156 157 102 102 320 102 102 102 102 102 164 165 165 165 165 165 165 165 165 165 165 165 165 165 165 165 165 165 165 165 165 165 165 165 165 165 165 165 165 165 165 165 165 165 165 165 165 165 165 165 165 165 165 216 141 102 102 102 139 141 102 102 102 102 102 102 102 102 226 176 292 292 292 292 292 292 292 292 292 292 292 292 292 292 292 292 292 292 292 292 292 292 292 292 292 292 5 80 31 31 31 31 31 31 31 31 31 31 31 31 31 31 31 31 31 31 31 31 31 31 31 31 31 31 31 31 2 78 28 28 28 28 28 28 
363 363 363 363 363 363 363 363 363 364 289 289 289 289 289 289 289 369 76 76 76 133 209 102 102 102 102 189 190 191 102 102 102 102 189 240 241 191 102 102 322 102 189 190 191 102 189 191 102 102 251 292 177 228 102 102 102 102 102 102 155 156 156 156 156 156 156 157 102 102 102 102 102 102 102 102 164 165 165 165 165 165 165 165 165 165 165 165 165 165 165 165 165 165 165 165 165 165 165 165 165 165 165 165 165 165 165 165 165 165 165 165 165 165 165 165 165 165 165 165 166 102 102 139 215 216 141 102 102 102 139 141 102 102 251 292 292 292 292 292 292 292 292 292 292 292 292 292 292 292 292 292 292 292 292 292 292 292 292 292 292 5 80 31 31 31 31 31 31 31 31 31 31 31 31 31 31 31 31 31 31 31 31 31 31 31 31 31 31 31 31 31 27 28 28 28 28 28 28 28 
363 363 363 363 363 363 363 363 363 364 289 289 289 391 289 289 289 369 76 76 76 158 102 102 102 102 102 102 102 102 102 102 102 102 102 189 191 102 102 102 102 102 102 102 102 102 321 102 102 102 251 292 292 177 228 102 102 102 102 102 155 156 156 156 156 156 156 83 131 132 102 102 322 102 102 102 164 165 165 165 165 165 165 165 165 165 165 165 165 165 165 165 165 165 165 165 165 165 165 165 165 165 165 165 165 165 165 165 165 165 165 165 165 165 165 165 165 165 165 165 166 102 102 189 240 241 191 102 102 102 189 191 102 226 176 292 292 292 292 292 292 292 292 292 292 292 292 292 292 292 292 292 292 292 292 292 292 292 292 292 5 80 31 31 31 31 31 31 31 31 31 31 31 31 31 31 31 31 31 31 31 31 31 31 31 31 31 31 31 31 2 3 78 28 28 28 28 28 28 28 
363 363 363 363 363 363 363 363 366 389 289 289 289 289 289 289 289 369 76 76 76 158 102 139 141 102 320 102 102 139 140 140 140 140 140 140 140 140 141 102 102 102 102 139 141 102 102 102 102 102 276 201 292 292 253 102 102 102 102 102 180 181 107 156 156 156 156 156 156 83 131 132 102 102 320 102 164 165 165 165 165 165 165 165 165 165 165 165 165 165 165 165 165 165 165 165 165 165 165 165 165 165 165 165 165 165 165 165 165 165 165 165 165 165 165 165 165 165 165 165 166 102 102 102 189 191 102 102 102 102 102 102 226 176 292 292 292 292 292 292 292 292 292 292 292 292 292 292 292 292 292 292 292 292 292 292 292 292 5 6 80 31 31 31 31 31 31 31 31 31 31 31 31 31 31 31 31 31 31 31 31 31 31 31 31 31 31 31 2 3 78 28 28 28 28 28 28 28 28 28 
363 363 363 363 363 363 363 366 389 289 289 289 289 289 289 289 289 129 344 76 76 158 102 189 191 102 102 139 102 215 165 165 165 165 165 165 165 165 216 140 140 141 102 189 191 102 102 139 141 102 102 276 201 292 177 228 102 320 102 102 102 102 180 107 156 295 156 156 156 156 156 83 131 132 102 102 189 240 165 165 165 165 165 165 165 165 165 165 165 165 165 165 165 165 165 165 165 165 165 165 165 165 165 165 165 165 165 165 165 165 165 165 165 165 165 165 165 165 165 241 191 102 102 102 102 102 102 102 102 102 102 102 251 292 292 292 292 292 292 292 292 292 292 292 292 292 292 292 292 292 292 292 292 292 292 292 292 5 80 31 31 31 31 31 31 31 31 31 31 31 31 31 31 31 31 31 31 31 31 31 31 2 3 3 3 3 3 3 78 28 28 28 28 28 28 28 28 28 28 28 
363 363 363 363 363 363 366 389 289 289 391 289 391 289 289 390 289 289 369 76 76 158 102 102 335 102 102 164 165 165 165 165 165 165 165 165 165 165 165 165 165 216 140 141 102 102 139 215 216 141 102 102 251 292 292 253 102 102 102 102 102 102 102 155 156 156 156 156 346 156 156 156 156 157 102 102 102 189 190 240 165 165 165 165 165 165 165 165 165 165 165 165 165 165 165 165 165 165 165 165 165 165 165 165 165 165 165 165 165 165 165 165 165 165 165 165 165 165 165 166 102 102 102 102 102 102 102 102 102 102 102 226 176 292 292 292 292 292 292 292 292 292 292 292 292 292 292 292 292 292 292 292 292 292 5 6 6 80 31 31 31 31 31 31 31 31 31 31 31 31 31 31 31 31 31 31 31 2 3 3 3 78 28 28 28 28 28 28 28 28 28 28 28 28 28 28 28 28 28 28 
363 363 363 363 363 363 364 289 289 289 289 289 289 289 289 289 289 289 369 76 76 158 102 102 102 102 102 164 165 165 165 165 165 165 165 165 165 165 165 165 165 165 165 216 141 102 189 240 241 191 102 102 276 201 292 177 228 102 102 102 102 322 102 155 156 156 156 156 156 156 270 156 156 83 132 102 102 102 102 189 240 165 165 165 165 165 165 165 165 165 165 165 165 165 165 165 165 165 165 165 165 165 165 165 165 165 165 165 165 165 165 165 165 165 165 165 165 165 241 191 102 102 102 102 102 139 141 102 102 159 102 251 292 292 292 292 292 292 292 292 292 292 292 292 292 292 292 292 292 292 292 292 292 5 80 31 31 31 31 31 31 31 31 31 31 31 31 31 31 31 31 31 31 31 31 2 3 78 28 28 28 28 28 28 28 28 28 28 28 28 28 28 28 28 28 28 28 28 28 28 
363 363 363 363 363 366 389 289 289 289 390 289 289 289 289 289 289 289 369 76 76 158 102 102 102 102 102 164 165 165 165 165 165 165 165 165 165 165 165 165 165 165 165 165 166 102 102 189 191 102 321 102 102 276 201 292 253 102 102 102 102 102 102 180 107 156 156 156 156 156 156 156 156 156 157 102 102 102 102 102 189 240 165 165 165 165 165 165 165 165 165 165 165 165 165 165 165 165 165 165 165 165 165 165 165 165 165 165 165 165 165 165 165 165 165 165 165 241 191 102 102 102 102 102 102 189 191 102 102 102 102 251 292 292 292 292 292 292 292 292 292 292 292 292 292 292 292 292 292 292 292 5 6 80 31 31 31 31 31 31 31 31 31 31 31 31 31 31 31 31 31 31 31 31 2 78 28 28 28 28 28 28 28 28 28 28 28 28 28 28 28 28 28 28 28 28 28 28 28 28 
363 363 363 363 363 364 289 289 289 289 289 289 289 289 289 289 289 154 394 76 76 158 102 102 139 141 102 189 240 165 165 165 165 165 165 165 165 165 165 165 165 165 165 165 216 141 102 139 141 102 102 102 102 102 251 292 253 102 102 102 320 102 102 102 155 156 156 270 156 156 156 156 156 156 157 102 102 102 322 102 102 189 102 240 165 165 165 165 165 165 165 165 165 165 165 165 165 165 165 165 165 165 165 165 165 165 165 165 165 165 165 165 165 165 165 165 165 166 102 102 257 258 259 102 102 102 102 102 102 102 226 176 292 292 292 292 292 292 292 292 292 292 292 292 292 292 292 292 292 292 5 80 31 31 31 31 31 31 31 31 31 31 31 31 31 31 31 31 31 31 31 31 31 2 78 28 28 28 28 28 28 28 28 28 28 28 28 28 28 28 28 28 28 28 28 28 28 28 28 28 
363 363 363 363 366 389 289 391 289 289 289 289 289 289 391 289 289 369 76 76 76 158 102 139 215 216 141 102 189 240 165 165 165 165 165 165 165 165 165 165 165 165 165 165 165 166 102 189 191 102 102 322 102 102 251 292 177 228 102 102 102 102 102 102 180 181 107 156 156 156 156 295 156 156 157 102 320 102 102 102 139 141 102 189 240 165 165 165 165 165 165 165 165 165 165 165 165 165 165 165 165 165 165 165 165 165 165 165 165 165 165 165 165 165 165 165 241 191 102 102 282 283 284 102 102 102 102 102 102 102 251 292 292 292 292 292 292 292 292 292 292 292 292 292 292 292 292 292 292 5 80 31 31 31 31 31 31 31 31 31 31 31 31 31 31 31 31 31 31 31 31 2 3 78 28 28 28 28 28 28 28 28 28 28 28 28 28 28 28 28 28 28 28 28 28 28 28 28 28 28 
363 363 363 366 389 289 289 289 289 289 289 390 289 289 289 289 289 369 76 76 76 158 102 189 240 241 191 102 102 164 165 165 165 165 165 165 165 165 165 165 165 165 165 165 165 166 102 102 102 139 141 102 102 102 276 201 292 253 102 102 102 102 102 102 102 102 180 107 156 156 156 156 156 156 157 102 102 102 102 102 189 191 102 102 189 190 190 240 165 165 165 165 165 165 165 165 165 165 165 165 165 165 165 165 165 165 165 165 165 165 165 165 165 165 165 241 191 102 102 102 307 308 309 102 102 102 102 102 102 226 176 292 292 292 292 292 292 292 292 292 292 292 292 292 292 292 292 292 5 80 31 31 31 31 31 31 31 31 31 31 31 31 31 31 31 31 31 31 31 31 31 27 28 28 28 28 28 28 28 28 28 28 28 28 28 28 28 28 28 28 28 28 28 28 28 28 28 28 28 28 
363 363 366 389 289 289 289 289 289 289 289 289 289 289 289 289 289 369 76 76 76 158 102 102 189 191 102 102 102 189 240 165 165 165 165 165 165 165 165 165 165 165 165 165 165 166 102 102 139 215 216 141 102 102 102 251 292 177 228 102 102 102 102 102 322 102 102 180 107 156 156 156 156 108 182 102 102 102 102 102 102 102 102 102 102 102 102 189 190 190 190 240 165 165 165 165 165 165 165 165 165 165 165 241 190 240 165 165 165 165 165 165 165 241 190 191 102 102 102 102 102 102 102 102 102 102 102 102 102 251 292 292 292 292 292 292 292 292 292 292 292 292 292 292 292 292 292 5 80 31 31 31 31 31 31 31 31 31 31 31 31 31 31 31 31 31 31 31 31 31 31 27 28 28 28 28 28 28 28 28 28 28 28 28 28 28 28 28 28 28 28 28 28 28 28 28 28 28 28 28 
363 363 364 289 289 390 289 289 289 391 289 289 289 289 289 289 154 394 76 76 76 158 102 102 102 102 102 102 102 102 189 240 165 165 165 165 165 165 165 165 165 165 165 165 241 191 102 102 189 240 241 191 139 141 102 276 201 292 253 322 102 102 102 102 102 102 102 102 180 181 181 181 181 182 102 102 102 102 102 102 102 102 102 102 102 102 102 102 102 102 139 215 165 165 165 165 165 165 165 165 165 165 165 166 102 189 190 240 165 165 165 165 241 191 102 102 102 102 102 102 102 102 139 140 141 102 102 102 102 251 292 292 292 292 292 292 292 292 292 292 292 292 292 292 292 292 292 30 31 31 31 31 31 31 31 31 31 31 31 31 31 31 31 31 31 31 31 31 31 31 31 27 28 28 28 28 28 28 28 28 28 28 28 28 28 28 28 28 28 28 28 28 28 28 28 28 28 28 28 28 
363 366 389 289 289 289 337 338 339 289 289 289 289 289 289 289 369 76 76 76 76 158 102 102 102 102 102 139 141 102 102 189 190 240 165 165 165 165 165 165 165 165 165 165 166 102 102 102 102 189 191 102 189 191 102 102 251 292 253 102 102 102 102 102 102 102 320 102 102 102 102 102 102 102 102 102 102 102 102 322 102 102 102 102 102 139 141 102 102 102 164 165 165 165 165 165 165 165 165 165 165 241 190 191 102 102 102 189 190 240 165 241 191 102 102 102 102 139 141 102 102 102 164 165 166 102 159 102 102 251 292 292 292 292 292 292 292 292 292 292 292 292 292 292 292 292 292 30 31 31 31 31 31 31 31 31 31 31 31 31 31 31 31 31 31 31 31 31 31 31 31 27 28 28 28 28 28 28 28 28 28 28 28 28 28 28 28 28 28 28 28 28 28 28 28 28 28 28 28 28 
388 389 289 337 338 338 340 363 341 338 339 289 289 390 289 154 394 76 76 76 76 158 102 102 102 335 102 189 191 102 102 102 102 189 190 190 190 190 190 190 190 190 190 190 191 102 139 141 102 102 102 102 102 102 226 227 176 292 177 227 227 227 227 227 227 228 102 102 102 102 102 102 102 102 102 102 102 102 102 102 102 102 102 102 102 189 191 102 102 102 164 165 165 165 165 165 165 165 165 165 165 166 102 102 102 139 141 102 102 189 190 191 102 102 102 102 102 189 191 102 102 102 189 190 191 102 102 102 102 251 292 292 292 292 292 292 292 292 292 292 292 292 292 292 292 292 292 30 31 31 31 31 31 31 31 31 31 31 31 31 31 31 31 31 31 31 31 31 31 31 31 52 53 103 28 28 28 28 28 28 28 28 28 28 28 28 28 28 28 28 28 28 28 28 28 28 28 28 28 28 
289 289 337 340 363 363 363 363 363 363 341 339 289 289 289 369 76 76 76 76 133 209 102 102 139 140 141 102 102 102 102 139 141 102 102 102 102 102 102 320 102 102 102 102 102 322 189 191 102 102 102 226 227 227 176 292 292 292 292 292 292 292 292 292 292 177 227 227 228 102 102 102 102 102 102 102 102 320 102 102 102 102 139 141 102 102 102 102 102 102 164 165 165 165 165 165 165 165 241 190 190 191 102 102 102 189 191 102 102 102 102 102 102 102 102 102 102 102 102 102 102 102 102 102 102 102 102 102 226 176 292 292 292 292 292 292 292 292 292 292 292 292 292 292 292 292 292 30 31 31 31 31 31 31 31 31 31 31 31 31 31 31 31 31 31 31 31 31 31 31 31 31 31 52 53 53 53 53 53 103 28 28 28 28 28 28 28 28 28 28 28 28 28 28 28 28 28 28 28 28 
338 338 340 363 363 363 363 363 363 363 363 364 289 289 289 369 76 76 76 76 158 102 102 102 164 165 166 102 102 102 139 215 216 141 102 139 141 102 102 102 102 102 102 102 102 102 102 102 102 226 227 176 292 292 292 292 292 292 292 292 292 292 292 292 292 292 292 292 177 228 102 322 102 320 102 102 102 102 102 102 102 139 215 216 141 102 102 102 102 102 189 190 190 190 190 240 165 165 166 102 102 102 102 102 102 102 102 102 102 102 102 102 139 140 140 140 140 140 141 102 102 102 102 102 102 102 102 102 251 292 292 292 292 292 292 292 292 292 292 292 292 292 292 292 292 292 292 55 105 31 31 31 31 31 31 31 31 31 31 31 31 31 31 31 31 31 31 31 31 31 31 31 31 31 31 31 31 31 31 52 103 28 28 28 28 28 28 28 28 28 28 28 28 28 28 28 28 28 28 28 
363 363 363 363 363 363 363 363 363 363 363 364 289 289 391 369 76 76 76 76 158 102 102 102 189 190 191 102 102 102 189 240 241 191 102 189 191 102 102 102 102 102 139 141 102 102 102 102 102 251 292 292 292 292 292 292 292 292 292 292 292 292 292 292 292 292 292 292 292 177 228 102 102 102 102 102 102 102 102 102 102 189 240 241 191 102 102 102 102 102 102 102 102 102 102 189 190 190 191 102 102 139 140 141 102 102 102 102 102 102 102 139 215 165 165 165 165 165 216 140 141 102 102 139 141 102 102 102 251 292 292 292 292 292 292 292 292 292 292 292 292 292 292 292 292 292 292 292 30 31 31 31 31 31 31 31 31 31 31 31 31 31 31 31 31 31 31 31 31 31 31 31 31 31 31 31 31 31 31 31 52 53 103 28 28 28 28 28 28 28 28 28 28 28 28 28 28 28 28 28 
363 363 363 363 363 363 363 363 363 363 363 341 339 289 289 369 76 76 76 76 158 102 102 102 102 102 102 102 322 102 102 189 191 102 102 102 102 102 102 335 102 102 189 191 102 102 320 102 226 176 292 292 292 292 292 292 292 292 292 292 292 292 292 292 292 292 292 292 292 292 177 228 102 102 102 322 102 102 139 141 102 102 189 191 102 102 139 140 141 102 102 102 139 141 102 102 102 102 102 102 102 164 165 166 102 257 258 259 102 102 139 215 165 165 165 165 165 165 165 165 166 102 102 189 191 102 102 226 176 292 292 292 292 292 292 292 292 292 292 292 292 292 292 292 292 292 292 292 30 31 31 31 31 31 31 31 31 31 31 31 31 31 31 31 31 31 31 31 31 31 31 31 31 31 31 31 31 31 31 31 31 31 52 103 28 28 28 28 28 28 28 28 28 28 28 28 28 28 28 28 
363 363 363 363 363 363 363 363 363 363 363 363 341 289 289 369 76 76 76 76 158 102 102 102 102 102 102 102 102 102 102 257 258 258 258 258 258 259 102 102 102 102 102 102 102 102 102 102 251 292 292 292 292 292 292 292 292 292 292 292 292 292 292 292 292 292 292 292 292 292 292 253 102 102 102 102 102 102 189 191 102 102 102 102 102 102 164 165 166 102 102 102 189 191 102 102 102 102 102 102 102 189 190 191 102 282 283 284 102 139 215 165 165 165 165 165 165 165 165 165 216 141 102 102 159 102 102 251 292 292 292 292 292 292 292 292 292 292 292 292 292 292 292 292 292 292 292 292 30 31 31 31 31 31 31 31 31 31 31 31 31 31 31 31 31 31 31 31 31 31 31 31 31 31 31 31 31 31 31 31 31 31 31 52 53 103 28 28 28 28 28 28 28 28 28 28 28 28 28 28
