20x20.bmp 200:24
165 165 165 165 165 165 165 165 165 165 165 165 165 165 165 165 165 165 165 165 165 165 165 165 165 165 165 165 165 165 165 165 165 241 191 283 283 283 283 283 283 283 283 283 283 283 276 201 177 227 228 283 283 283 283 283 283 283 307 308 308 308 232 283 283 283 189 190 191 283 283 335 283 207 308 309 283 276 201 177 228 283 321 283 226 176 202 277 278 283 283 283 283 139 140 140 140 140 215 165 165 165 165 165 165 165 165 165 165 165 165 165 165 165 165 165 165 165 165 165 165 165 165 165 165 165 165 241 191 283 283 283 283 283 283 222 146 147 283 283 334 283 283 283 283 283 170 283 283 283 283 283 164 165 241 191 283 283 130 131 131 131 131 132 283 283 283 283 283 283 334 283 283 283 283 283 283 283 283 283 283 283 276 201 51 51 51 51 51 51 51 51 51 51 51 51 51 51 51 51 
165 165 165 165 165 165 165 165 165 165 165 165 165 165 165 165 165 165 165 165 165 165 165 165 165 165 165 165 165 165 165 241 190 191 283 283 322 283 283 283 320 283 283 283 283 283 283 276 277 201 177 227 227 227 227 227 227 227 227 228 283 283 307 308 308 232 283 283 283 283 207 308 308 309 283 283 283 283 251 37 253 283 283 226 176 202 278 283 283 283 283 139 140 215 165 165 165 165 165 165 165 165 165 165 165 165 165 165 165 165 165 165 165 165 165 165 165 165 165 165 165 165 165 165 165 165 241 191 283 283 283 321 283 283 283 283 283 222 147 283 283 283 139 140 141 283 195 246 283 283 333 283 189 190 191 283 283 130 82 168 168 168 168 83 132 283 283 283 283 283 283 283 283 283 283 283 283 321 283 283 283 283 283 276 277 201 51 51 51 51 51 51 51 51 51 51 51 51 51 51 
165 165 165 165 165 165 165 165 165 165 165 165 165 165 165 165 165 165 165 165 165 165 165 165 165 165 165 165 165 165 241 191 283 283 283 283 283 283 283 283 283 283 283 283 322 283 283 283 283 276 277 277 277 277 277 277 277 277 201 177 227 228 283 283 283 307 308 308 308 308 309 283 283 283 283 283 283 283 276 201 177 227 227 176 202 278 283 283 283 139 140 215 165 165 165 165 165 165 165 165 165 165 165 165 165 165 165 165 165 165 165 165 165 165 165 165 165 165 165 165 165 165 165 165 165 241 191 283 283 283 283 283 283 283 335 283 283 283 222 147 283 283 164 165 166 283 283 170 283 283 283 283 283 283 283 334 130 82 168 168 168 168 346 168 157 283 283 283 283 283 283 283 283 257 258 259 283 283 283 283 283 283 283 283 283 276 201 51 51 51 51 51 51 51 51 51 51 51 51 51 
165 165 165 165 165 165 165 165 165 165 165 165 165 165 165 165 165 165 165 165 165 165 165 165 165 165 165 241 190 190 191 283 283 283 283 283 283 283 283 283 333 283 283 283 283 283 283 283 283 283 283 283 283 283 283 283 283 283 276 277 201 177 227 228 102 283 283 283 283 283 283 283 283 320 283 283 283 283 283 276 201 37 37 202 278 283 321 283 139 215 165 165 165 165 165 165 165 165 165 165 165 165 165 165 165 165 165 165 165 165 165 165 165 165 165 165 165 165 165 165 165 165 165 165 241 191 283 283 283 283 283 283 283 283 283 283 283 283 283 222 147 283 189 190 191 335 283 195 246 283 283 283 283 283 283 283 155 168 168 168 270 168 168 168 157 283 283 320 283 283 283 283 257 233 283 208 258 258 259 283 283 283 334 283 283 283 276 277 201 51 51 51 51 51 51 51 51 51 51 51 
165 165 165 165 165 165 165 165 165 165 165 165 165 165 165 165 165 165 165 165 165 165 165 241 190 190 190 191 283 283 283 283 336 283 283 283 283 283 283 283 283 283 283 283 283 283 283 283 283 283 283 283 283 283 283 320 283 283 283 283 276 277 201 177 227 228 283 283 283 283 283 283 283 283 283 283 283 334 283 102 251 37 202 278 283 283 283 139 215 165 165 165 165 165 165 165 165 165 165 165 165 165 165 165 165 165 165 165 165 165 165 165 165 165 165 165 165 165 165 165 165 165 165 165 166 283 283 283 336 283 283 139 140 141 283 283 283 283 283 283 222 147 283 283 283 283 283 283 170 283 283 283 336 283 283 283 155 168 168 168 168 168 295 168 157 283 283 283 283 283 283 257 233 283 139 140 141 283 208 259 283 283 283 283 283 283 283 283 276 277 277 201 51 51 51 51 51 51 51 51 
165 165 165 165 165 165 165 165 165 165 165 165 165 165 165 165 241 190 190 190 190 190 190 191 283 283 283 283 283 283 283 283 283 283 257 258 259 283 283 283 283 283 283 333 283 283 321 283 283 139 140 141 283 283 283 283 283 283 283 322 283 283 276 277 201 177 227 227 227 228 283 283 283 283 283 283 283 283 283 102 251 37 253 283 283 283 139 215 165 165 165 165 165 165 165 165 165 165 165 165 165 165 165 165 165 165 165 165 165 165 165 165 165 165 165 165 165 165 165 165 165 165 165 165 166 283 283 321 283 283 283 164 165 166 283 283 283 283 283 283 283 222 146 146 147 283 283 336 195 246 283 283 283 283 283 130 82 168 168 168 168 168 168 108 182 283 283 283 283 283 283 282 283 283 164 165 166 283 283 208 259 283 321 283 283 283 283 283 283 283 283 276 201 51 51 51 51 51 51 51 
165 165 165 165 165 165 165 165 165 165 165 165 165 165 241 190 191 283 283 283 283 283 283 283 283 283 283 283 283 283 257 258 258 258 233 283 208 258 258 259 283 283 283 283 283 283 283 283 283 164 165 166 283 283 283 283 283 283 283 283 283 283 226 227 176 202 277 277 201 177 227 228 283 283 283 283 283 283 283 226 176 202 278 283 283 283 164 165 165 165 165 165 165 165 165 165 165 165 165 165 165 165 165 165 165 165 165 165 165 165 165 165 165 165 165 165 165 165 165 165 165 165 165 165 166 283 283 283 283 283 283 189 190 191 334 283 283 283 283 283 283 283 283 171 222 147 283 283 283 170 283 130 131 131 131 82 168 168 168 295 168 168 168 83 132 283 283 321 283 283 283 307 232 283 189 190 191 283 283 283 284 283 283 283 283 283 283 283 283 283 283 283 251 51 51 51 51 51 51 51 
165 165 165 165 165 165 165 165 165 165 165 165 165 241 191 283 283 283 283 283 283 283 335 283 333 283 283 257 258 258 233 283 283 283 283 336 283 283 283 208 259 283 283 283 283 283 283 283 283 189 190 191 283 335 283 333 283 283 283 226 227 227 176 202 277 278 283 283 276 277 201 177 227 228 283 283 283 283 226 176 37 253 283 283 283 139 215 165 165 165 165 165 165 165 165 165 165 165 165 165 165 165 165 165 165 165 165 165 165 165 165 165 165 165 165 165 165 165 165 165 165 165 165 165 216 141 283 283 283 283 283 283 283 283 283 283 283 283 283 283 333 283 283 283 283 222 147 283 283 195 224 82 168 168 168 168 168 346 168 168 168 168 168 168 83 132 283 283 283 283 283 283 307 232 283 283 283 283 283 207 309 283 283 283 283 283 283 283 283 283 283 283 276 201 51 51 51 51 51 51 
165 165 165 165 165 165 165 165 165 165 165 165 241 191 283 283 283 283 283 283 283 283 283 283 283 283 257 233 283 139 140 140 140 140 141 283 283 283 321 283 284 283 283 283 283 283 283 283 283 283 283 283 283 283 283 283 283 226 227 176 202 277 277 278 283 283 283 283 283 283 276 277 201 177 227 228 283 283 251 37 202 278 283 283 283 164 165 165 165 165 165 165 165 165 165 165 165 165 165 165 165 165 165 165 165 165 165 165 165 165 165 165 165 165 165 165 165 165 165 165 165 165 165 165 165 166 283 283 283 283 283 283 283 283 283 283 283 283 283 283 283 283 322 283 283 283 222 147 283 142 94 168 168 168 168 168 168 168 168 168 168 168 168 168 168 157 283 283 283 283 283 283 283 307 308 308 308 308 308 309 283 283 283 283 283 335 283 283 139 140 141 283 283 276 201 51 51 51 51 51 
165 165 165 165 165 165 165 165 165 165 165 241 191 283 283 283 320 283 139 140 141 283 283 283 283 257 233 139 140 215 165 165 165 165 216 141 283 283 283 283 284 283 283 334 283 283 283 283 283 283 283 283 283 283 226 227 227 176 202 277 278 283 283 283 283 283 283 283 283 283 283 283 276 277 201 177 227 227 176 37 253 283 283 320 283 164 165 165 165 165 165 165 165 165 165 165 165 165 165 165 165 165 165 165 165 165 165 165 165 165 165 165 165 165 165 165 165 165 165 165 165 165 165 165 165 166 283 283 283 283 283 283 283 283 283 283 283 283 283 283 283 283 283 283 283 283 283 222 147 167 168 168 168 168 168 168 295 168 168 168 168 168 168 168 168 83 132 283 283 283 283 283 283 283 283 283 283 283 283 283 283 283 283 283 283 283 283 283 164 165 166 283 283 283 276 201 51 51 51 51 
165 165 165 165 165 165 165 165 165 165 165 166 283 283 283 283 283 283 164 165 166 283 283 283 257 233 283 164 165 165 165 165 165 165 165 166 334 283 283 207 309 283 283 283 283 283 283 322 283 283 283 283 226 227 176 202 277 277 278 283 283 283 283 283 283 283 283 283 283 283 283 283 283 283 276 277 201 37 37 202 278 283 283 283 139 215 165 165 165 165 165 165 165 165 165 165 165 165 165 165 165 165 165 165 165 165 165 165 165 165 165 165 165 165 165 165 165 165 165 165 165 165 165 165 165 166 283 283 283 283 283 283 322 283 257 258 258 258 258 259 283 283 283 283 283 283 283 171 223 94 168 168 168 168 168 168 168 168 347 168 168 168 295 168 168 168 83 132 283 320 283 283 283 283 283 283 283 283 283 283 283 283 283 320 283 283 283 283 189 190 191 283 283 283 283 251 51 51 51 51 
165 165 165 165 165 165 165 165 165 165 165 216 141 333 283 283 283 283 189 190 191 283 283 283 282 283 283 164 165 165 165 165 165 165 165 166 283 283 207 309 283 283 283 283 139 140 141 283 283 283 283 226 176 202 277 278 283 283 283 283 283 283 320 283 283 283 283 283 283 283 283 334 283 283 283 283 276 201 37 253 283 283 283 283 164 165 165 165 165 165 165 165 165 165 165 165 165 165 165 165 165 165 165 165 165 165 165 165 165 165 165 165 165 165 165 165 165 165 165 165 165 165 165 165 165 166 283 283 333 283 283 283 283 257 233 283 335 283 283 208 259 283 283 283 320 283 283 283 155 168 168 168 168 168 168 168 168 168 168 168 168 168 168 168 347 168 168 157 283 283 283 283 334 283 283 283 283 283 283 283 283 283 283 283 283 283 283 283 283 283 283 283 283 283 283 276 201 51 51 51 
165 165 165 165 165 165 165 165 165 165 165 165 216 141 283 283 283 283 283 283 283 283 283 283 282 283 283 164 165 165 165 165 165 165 241 191 283 207 309 283 283 283 322 283 164 165 166 283 283 283 226 176 202 278 283 283 283 283 283 283 283 283 283 257 258 258 258 258 258 259 283 283 283 283 283 283 283 251 37 253 283 283 283 283 164 165 165 165 165 165 165 165 165 165 165 165 165 165 165 165 165 165 165 165 165 165 165 165 165 165 165 165 165 165 165 165 165 165 165 165 165 165 165 165 241 191 283 283 283 283 283 283 257 233 139 140 140 140 140 141 208 259 283 283 283 283 283 283 155 168 346 168 295 168 168 168 168 345 168 168 295 168 168 168 168 168 168 157 283 283 283 283 283 283 283 283 283 148 149 149 149 149 150 283 283 283 283 283 321 283 283 283 322 283 283 283 276 201 51 51 
165 165 165 165 165 165 165 165 165 165 165 165 165 216 141 283 283 283 283 283 283 283 283 283 282 283 283 164 165 165 165 165 165 241 191 283 207 309 283 283 283 283 283 283 189 190 191 283 283 226 176 202 278 283 283 283 283 333 283 283 283 257 258 233 283 283 283 283 283 208 259 283 283 283 283 283 283 251 37 253 283 283 283 283 189 190 240 165 165 165 165 165 165 165 165 165 165 165 165 165 165 165 241 190 190 190 190 190 190 190 190 190 240 165 165 165 165 165 165 165 165 165 165 165 166 283 283 283 283 283 283 283 282 283 164 165 165 165 165 166 283 284 283 283 283 283 283 283 155 168 168 168 168 168 168 270 168 168 168 168 168 168 168 168 168 168 168 157 283 283 283 283 283 283 283 148 149 152 174 174 174 174 151 149 149 149 150 283 283 283 283 283 283 283 283 283 283 251 51 51 
165 165 165 165 165 165 165 165 165 165 165 165 165 165 166 283 335 283 283 283 283 283 283 283 307 232 283 283 190 190 190 190 190 191 283 207 309 283 283 283 283 283 283 283 283 283 283 283 226 176 202 278 283 283 283 283 283 283 283 257 258 233 283 283 283 336 283 320 283 283 208 259 283 283 283 334 283 251 37 253 283 283 334 283 283 283 164 165 165 165 165 165 165 165 165 165 165 165 165 165 241 190 191 283 283 283 283 283 335 283 283 283 189 190 240 165 165 165 165 165 165 165 165 241 191 283 283 283 283 283 283 283 282 283 164 165 165 165 165 166 283 284 283 283 334 283 321 283 155 168 168 347 168 168 168 168 168 168 168 168 168 168 168 346 168 168 168 157 283 283 283 283 283 283 283 173 174 174 174 174 174 174 174 174 174 174 151 149 150 283 283 283 283 283 283 283 283 251 51 51 
165 165 165 165 165 165 165 165 165 165 165 165 165 165 166 283 283 283 283 283 283 283 334 283 283 307 308 308 308 308 308 308 308 308 308 309 283 283 283 283 283 283 283 283 283 283 283 226 176 202 278 283 283 322 283 283 283 257 258 233 283 283 322 283 283 283 283 283 283 283 283 208 259 283 283 283 283 251 37 253 283 283 283 283 283 283 189 240 165 165 165 165 165 165 165 165 165 165 165 241 191 283 283 283 283 283 283 283 283 283 283 283 283 283 189 190 240 165 165 165 165 241 190 191 283 283 283 283 322 283 283 283 282 283 164 165 165 165 165 166 321 284 283 283 283 283 283 283 155 168 168 168 168 168 168 168 168 168 347 168 168 168 168 168 168 270 168 157 283 283 335 283 283 283 148 152 174 174 174 174 174 174 174 174 174 174 174 174 151 150 283 283 283 283 283 283 283 276 201 51 
165 165 165 165 165 165 165 165 165 165 165 165 165 165 166 283 283 283 283 283 283 333 283 283 283 283 283 321 283 283 283 283 283 283 283 283 283 283 283 334 283 283 283 283 283 283 226 176 202 278 283 283 283 283 283 257 258 233 283 283 283 283 283 283 257 258 258 259 283 283 283 283 284 283 283 283 283 251 37 253 283 283 283 283 283 283 283 189 190 190 190 190 190 190 190 190 190 190 190 191 283 283 283 283 334 283 283 283 283 283 283 283 283 320 283 283 189 190 190 190 190 191 283 283 283 283 283 283 283 283 283 283 282 283 164 165 165 165 165 166 283 284 283 283 283 283 283 171 248 193 119 168 168 168 168 168 168 168 168 168 168 168 168 295 168 168 168 157 283 283 283 283 283 283 173 174 174 174 174 174 174 174 174 174 174 174 174 174 174 151 150 283 283 283 334 283 283 283 251 51 
165 165 165 165 165 165 165 165 165 165 165 165 165 165 166 283 283 320 283 283 283 283 283 283 283 283 283 283 283 283 283 283 283 283 283 283 283 283 283 283 283 283 283 283 226 227 176 202 278 283 283 283 283 257 258 233 283 283 283 283 257 258 258 258 233 283 283 208 259 283 335 283 284 283 283 283 283 251 37 253 283 283 283 283 283 283 283 335 283 283 283 283 283 283 283 283 226 227 227 227 227 227 228 283 283 283 321 283 283 283 283 283 283 283 283 283 283 283 283 283 283 283 283 283 283 283 283 283 283 283 283 283 307 232 189 240 165 165 165 166 334 284 283 320 283 283 247 196 197 283 167 168 168 168 168 168 168 168 168 168 168 168 168 168 168 168 168 157 283 283 283 283 283 283 173 174 174 174 174 174 174 174 174 174 174 174 174 174 174 174 175 283 283 283 283 283 283 283 276 201 
165 165 165 165 165 165 165 165 165 165 165 165 165 165 166 283 283 283 283 283 283 283 283 283 283 322 283 283 283 283 283 283 283 283 322 283 283 283 283 283 283 283 283 226 176 202 277 278 283 283 283 283 257 233 283 334 283 283 283 257 233 283 283 283 283 283 283 283 284 283 283 283 208 259 283 283 283 251 37 253 283 283 283 320 283 283 283 283 283 283 283 283 283 226 227 227 176 51 51 51 51 51 177 228 283 283 283 283 283 333 283 283 283 283 283 283 283 283 283 283 283 334 283 283 283 336 283 283 283 283 333 283 283 307 232 189 190 190 190 191 283 284 283 283 283 247 197 283 283 283 167 168 168 168 168 270 168 168 168 347 168 168 168 168 168 168 108 182 283 283 283 283 283 283 173 174 174 174 174 174 174 174 174 174 174 174 174 174 174 174 175 283 333 283 283 335 283 283 283 276 
165 165 165 165 165 165 165 165 165 165 165 165 165 241 191 283 283 283 139 140 140 140 140 140 140 140 140 141 283 283 283 283 283 333 283 283 320 283 283 283 283 283 226 176 202 278 283 283 283 283 257 258 233 283 283 283 283 257 258 233 283 283 283 336 283 283 283 283 208 259 283 283 283 284 283 283 283 251 37 253 283 283 283 283 283 283 283 283 283 283 283 226 227 176 51 51 202 277 277 277 277 277 201 177 228 283 283 283 283 283 283 283 283 283 283 283 283 283 283 283 283 283 283 283 283 283 283 283 283 283 283 283 283 283 307 232 283 283 283 283 207 309 283 283 247 197 283 283 283 283 167 168 168 168 168 168 168 168 168 168 168 168 168 168 168 168 157 283 283 283 283 283 283 283 173 174 174 174 174 174 174 174 174 174 174 174 174 174 174 174 175 283 283 283 283 283 283 283 283 283 
165 165 165 165 165 165 165 165 165 165 165 165 241 191 283 283 283 139 215 165 165 165 165 165 165 165 165 216 140 140 141 283 283 283 283 283 283 283 283 283 283 226 176 202 278 283 283 283 283 257 233 283 283 283 283 257 258 233 283 283 283 139 140 140 140 140 140 141 283 284 283 321 283 208 259 283 283 251 37 253 283 283 283 283 283 283 321 283 283 283 226 176 202 277 277 277 278 283 283 283 283 283 276 201 177 227 227 227 228 283 283 283 283 283 283 283 336 283 139 140 141 283 283 283 283 283 283 283 283 283 283 283 283 283 283 307 308 308 308 308 309 283 283 247 197 283 283 283 336 283 192 119 168 168 168 168 168 168 168 168 168 347 168 168 168 108 182 283 283 283 320 283 283 283 173 174 174 174 174 174 174 174 174 174 174 174 174 174 126 199 200 283 283 283 139 140 141 283 283 283 
165 165 165 165 165 165 165 165 165 165 165 241 191 283 283 283 139 215 165 165 165 165 165 165 165 165 165 165 165 165 216 141 283 283 283 283 283 283 283 226 227 176 202 278 283 333 283 283 257 233 283 283 283 283 257 233 283 283 139 140 140 215 165 165 165 165 165 166 283 208 259 283 283 283 284 283 283 276 201 177 228 283 334 283 283 283 283 283 283 226 176 202 278 283 283 283 283 283 283 283 283 283 283 276 201 37 37 37 177 227 228 283 283 283 283 283 283 283 164 165 166 283 283 283 283 283 283 283 283 283 283 283 283 283 283 283 283 283 283 283 283 283 247 197 283 336 283 283 283 283 283 167 168 168 345 168 168 168 168 168 168 168 168 168 108 182 283 283 283 283 283 283 283 283 198 127 174 174 174 174 174 174 174 126 199 199 199 199 200 283 283 283 283 283 164 165 166 283 283 283 
165 165 165 165 165 165 165 165 165 165 241 191 283 283 283 139 215 165 165 165 165 165 165 165 165 165 165 165 165 165 165 166 283 283 283 283 283 226 227 176 202 277 278 283 283 283 283 283 282 283 334 283 283 257 233 283 334 139 215 165 165 165 165 165 165 165 165 166 283 283 208 259 283 283 208 259 283 283 251 37 177 228 283 283 283 283 283 283 226 176 202 278 283 283 283 283 283 283 283 334 283 283 283 283 276 277 277 277 201 37 177 227 228 283 283 283 283 283 189 190 191 283 283 283 283 226 227 227 227 227 228 283 283 321 283 283 283 283 283 283 283 247 197 283 283 139 140 141 335 283 283 167 168 168 168 168 295 168 168 270 168 168 168 108 182 283 283 283 321 283 283 334 283 283 283 198 199 199 199 199 199 199 199 200 283 283 283 283 283 283 283 283 283 283 189 190 191 283 333 283 
165 165 165 165 165 165 165 165 165 241 191 283 283 336 283 164 165 165 165 165 165 165 165 165 165 165 165 165 165 165 165 216 140 141 283 283 226 176 202 277 278 283 283 283 283 283 257 258 233 283 283 257 258 233 283 283 283 215 165 165 165 165 165 165 165 165 165 216 141 283 283 208 259 283 283 208 258 259 276 201 37 177 228 283 283 226 227 227 176 202 278 283 283 139 140 141 283 283 283 283 283 283 283 283 283 283 283 283 276 277 201 37 253 283 283 283 283 283 283 283 283 283 283 283 226 176 202 277 277 201 177 228 283 283 139 140 141 283 283 247 196 197 283 283 139 215 165 166 283 283 145 249 107 168 168 168 168 168 168 108 181 181 181 182 283 283 283 283 283 283 283 283 283 283 283 283 283 283 283 283 283 283 283 283 283 283 283 283 283 283 283 283 283 283 283 283 283 283 283 283
