20x20.bmp 300:24
28 28 28 28 28 28 28 28 28 79 4 31 31 31 31 31 31 31 31 31 52 103 28 28 28 28 28 28 28 28 28 28 28 28 28 28 28 28 28 28 28 28 28 28 28 29 31 31 31 31 31 31 31 31 31 31 31 32 34 34 34 34 34 34 34 34 34 34 34 34 202 278 102 102 102 102 102 102 102 102 164 165 166 102 102 322 102 226 176 34 34 34 34 34 34 34 34 34 34 34 34 34 253 102 321 102 102 130 82 156 156 156 156 156 156 156 156 156 156 156 108 182 102 102 102 102 102 102 102 102 198 127 174 174 174 174 174 174 174 174 174 174 174 174 126 200 102 102 102 102 102 102 164 165 165 165 165 166 102 102 102 102 210 135 76 392 153 289 387 388 365 363 363 363 363 363 363 363 363 363 363 363 363 363 366 389 289 369 76 76 158 102 102 189 240 165 165 165 165 165 165 165 165 165 165 165 165 241 191 102 102 102 102 251 34 34 34 34 55 105 31 31 31 31 31 31 31 31 31 31 31 31 31 31 31 31 31 31 31 31 31 31 31 31 31 31 31 31 31 31 31 31 31 32 34 34 34 34 34 34 34 34 34 34 34 34 34 34 34 34 34 34 34 177 228 102 102 102 102 102 102 102 359 301 329 301 329 301 329 358 102 102 102 102 102 102 102 102 102 139 
28 28 28 28 28 28 28 28 28 28 79 3 3 4 31 31 31 31 31 31 31 52 103 28 28 28 28 28 28 28 28 28 28 28 28 28 28 28 28 28 28 28 28 104 53 54 31 31 31 31 31 31 31 31 31 31 106 57 34 34 34 34 34 34 34 34 34 34 34 34 253 102 102 102 102 102 102 322 102 102 189 190 191 102 102 102 226 176 34 34 34 34 34 34 34 34 34 34 34 34 34 202 278 102 102 102 130 82 156 156 156 156 156 156 156 156 156 156 156 156 157 102 102 102 320 102 102 102 321 102 102 173 174 174 174 174 174 174 174 174 174 174 174 174 175 102 102 102 102 102 102 102 189 190 190 190 190 191 102 102 102 102 102 160 76 76 392 393 393 153 387 388 388 365 363 363 363 363 363 363 363 363 363 366 389 289 154 394 76 76 158 102 102 102 164 165 165 165 165 165 165 165 165 165 165 165 241 191 102 102 102 102 102 276 201 34 34 34 34 55 105 31 31 31 31 31 31 106 56 56 105 31 31 31 31 31 31 31 31 31 31 31 31 31 31 31 31 31 31 31 31 31 106 57 34 34 34 34 34 34 34 34 34 34 34 34 34 34 34 34 34 34 34 34 177 227 227 228 102 102 102 102 384 351 379 351 379 351 379 383 102 335 102 102 102 102 102 102 139 215 
28 28 28 28 28 28 28 28 28 28 28 28 28 79 4 31 31 31 31 31 31 31 52 53 103 28 28 28 28 28 28 28 28 28 28 28 28 28 28 28 28 28 104 54 31 31 31 31 31 31 31 31 31 31 31 31 32 34 34 34 34 34 34 34 34 34 34 34 34 202 278 102 102 102 320 102 102 102 102 102 102 321 102 102 102 226 176 34 34 34 34 34 34 34 34 34 34 34 34 34 202 278 102 102 102 130 82 156 156 156 156 270 156 156 345 156 156 347 156 156 157 102 321 102 102 102 102 102 102 102 102 173 174 174 174 174 174 174 174 174 174 174 174 126 200 102 102 102 102 102 102 102 102 102 102 102 102 102 102 102 102 102 102 210 135 76 76 76 76 392 153 289 289 387 388 388 365 363 363 363 363 363 366 389 289 154 394 76 133 134 209 102 102 139 215 165 165 165 165 165 165 165 165 165 165 165 166 102 102 102 102 102 102 102 276 277 201 34 34 34 55 56 56 56 56 56 56 57 34 34 55 105 31 31 31 106 105 31 31 31 31 106 56 105 31 106 56 56 56 56 56 56 57 34 34 34 34 34 34 34 202 201 34 34 34 34 34 34 34 34 34 34 34 34 34 34 34 177 228 102 335 102 102 102 102 102 102 102 102 102 102 102 102 102 102 102 102 139 215 165 
28 28 28 28 28 28 28 28 28 28 28 28 28 28 79 4 31 31 31 31 31 31 31 31 52 53 103 28 28 28 28 28 28 28 28 28 28 28 28 28 104 53 54 31 31 31 31 31 31 31 31 31 31 31 31 106 57 34 34 34 34 34 34 34 34 34 34 34 202 278 102 102 102 102 102 102 102 102 322 102 102 102 102 226 227 176 34 34 34 34 34 34 34 34 34 34 34 34 34 34 253 102 320 102 130 82 156 156 346 156 156 156 156 156 156 156 156 156 156 156 157 102 102 102 102 322 102 102 102 102 102 198 127 174 174 174 174 174 174 174 174 174 126 200 102 102 102 102 102 102 334 102 102 102 102 102 102 334 102 102 102 102 102 102 210 135 76 76 76 76 392 393 393 153 289 289 362 363 363 363 363 363 364 289 154 394 76 76 158 102 102 102 139 215 165 165 165 165 165 165 165 165 165 165 165 165 166 102 102 102 102 102 102 102 102 102 276 277 277 201 34 34 34 34 34 34 34 34 34 34 34 55 56 56 56 57 55 56 56 56 56 57 34 55 56 57 34 34 34 34 34 34 34 34 34 34 34 34 202 277 278 276 201 34 34 34 34 34 34 34 34 34 34 34 34 34 34 34 253 102 102 102 102 102 102 102 102 102 102 102 102 102 102 102 102 334 102 164 165 165 
28 28 28 28 28 28 28 28 28 28 28 28 28 28 28 79 4 31 31 31 31 31 31 31 31 31 52 103 28 28 28 28 28 28 28 28 28 104 53 53 54 31 31 31 31 31 31 31 31 31 31 31 31 31 31 32 34 34 34 34 34 34 34 34 34 34 34 202 278 102 102 139 140 141 102 102 102 102 102 102 102 226 227 176 34 34 34 34 34 34 34 34 34 34 34 34 34 34 34 202 278 102 102 130 82 156 156 156 156 156 156 156 156 156 156 156 295 156 156 108 182 102 102 102 102 102 102 102 320 102 102 102 198 127 174 174 174 174 174 174 126 199 200 102 102 102 102 102 102 102 102 102 102 102 102 102 102 102 102 102 102 102 333 102 102 210 135 76 76 76 76 76 76 392 393 153 387 388 388 388 388 388 389 154 394 76 76 133 209 102 102 139 215 165 165 165 165 165 165 165 165 165 165 165 165 165 216 141 102 102 102 102 102 102 102 102 102 102 102 276 201 34 34 34 34 34 34 34 34 34 34 34 34 34 34 34 34 34 34 34 34 34 34 34 34 34 34 34 34 34 34 34 34 34 34 34 202 277 278 102 102 102 251 34 34 34 34 34 34 34 34 34 34 34 34 34 34 34 177 228 102 102 102 102 102 102 336 102 102 102 102 102 102 102 102 102 139 215 165 165 
28 28 28 28 28 28 28 28 28 28 28 28 28 28 28 28 29 31 31 31 31 31 31 31 31 31 31 52 53 53 53 53 53 53 53 53 53 54 31 31 31 31 31 31 31 31 31 31 31 31 31 31 106 56 106 57 34 34 34 34 34 34 34 34 34 34 34 253 102 102 102 164 165 166 102 102 102 102 102 102 226 176 34 34 34 34 34 34 34 34 34 34 34 34 34 34 34 34 34 253 102 130 131 82 156 156 156 156 156 156 295 156 156 156 156 156 156 156 108 182 102 102 102 102 321 102 102 102 102 102 102 102 102 198 199 199 199 199 199 199 200 102 102 102 102 139 140 140 140 141 102 102 102 102 102 102 102 102 102 102 102 102 102 102 102 102 210 134 134 134 135 76 76 76 76 392 153 289 289 289 289 289 289 369 76 76 76 158 102 102 102 164 165 165 165 165 165 165 165 165 165 165 165 165 165 165 165 216 141 102 102 336 102 102 102 102 102 102 102 102 276 277 277 201 34 34 34 34 34 34 34 34 34 34 34 34 34 34 34 34 34 34 34 34 34 34 34 34 34 34 34 34 34 202 277 277 278 102 102 334 102 226 176 34 34 34 34 34 34 34 34 34 34 34 34 34 34 34 34 253 102 102 102 102 102 102 102 102 102 102 102 102 102 102 102 139 215 165 165 165 
28 28 28 28 28 28 28 28 28 28 28 28 28 28 28 28 29 31 31 31 31 31 31 31 31 31 31 31 31 31 31 31 31 31 31 31 31 31 31 31 31 31 31 31 31 31 31 31 31 31 31 106 57 34 34 34 34 34 34 34 34 34 34 34 34 34 34 253 102 320 102 189 190 191 102 102 102 226 227 227 176 34 34 34 34 34 34 34 34 34 34 34 34 34 34 34 34 34 202 278 102 155 156 156 156 156 156 156 156 156 156 156 156 156 156 156 156 156 157 102 102 320 102 102 102 102 102 102 102 102 102 102 102 102 102 102 102 102 102 102 102 102 102 102 139 215 165 165 165 216 141 102 102 102 102 102 235 184 184 184 184 184 234 102 102 102 102 102 102 102 210 134 134 135 76 76 392 393 393 393 393 393 393 394 76 76 133 209 102 334 102 164 165 165 165 165 165 165 165 165 165 165 165 165 165 165 165 165 216 141 102 102 102 102 102 335 102 102 102 102 102 102 102 276 277 277 201 34 34 34 34 34 34 34 34 34 34 34 34 34 34 34 34 34 34 34 34 34 34 34 34 34 202 278 102 102 102 102 102 102 102 251 34 34 34 34 34 34 34 5 6 6 6 6 7 34 34 34 34 253 102 102 102 102 102 102 102 102 102 102 102 102 102 102 139 215 165 165 165 165 
28 28 28 28 28 28 28 28 28 28 28 28 28 28 28 28 29 31 31 31 31 31 31 31 31 31 31 31 31 31 31 31 31 31 31 31 31 31 31 31 31 31 31 31 31 31 31 31 31 31 106 57 34 34 34 34 34 34 34 34 34 34 34 34 34 34 34 253 102 102 102 102 102 102 102 102 226 176 34 34 34 34 34 34 34 34 34 34 34 34 34 34 34 34 34 34 34 34 253 102 130 82 156 156 156 156 156 156 156 156 156 347 156 156 156 156 156 156 157 102 102 102 102 102 102 102 130 131 131 132 102 102 102 102 321 102 102 102 102 102 102 102 102 102 164 165 165 165 165 165 166 102 102 102 102 235 185 76 76 76 76 76 183 234 102 102 102 102 102 102 102 102 102 210 135 76 76 76 76 76 76 76 76 76 76 133 209 102 102 102 102 164 165 165 165 165 165 165 165 165 165 165 165 165 165 165 165 165 165 216 141 102 102 102 102 102 102 102 102 102 102 102 102 102 102 102 276 277 277 277 277 201 34 34 34 34 34 34 34 34 34 34 34 34 34 34 34 34 34 202 277 277 278 102 102 102 333 102 102 226 227 176 34 34 34 34 34 34 5 80 31 31 31 31 32 34 34 34 34 253 102 102 102 102 102 102 102 102 102 102 102 102 102 102 164 165 165 165 165 165 
28 28 28 28 28 28 28 28 28 28 28 28 28 28 28 104 54 31 31 31 31 31 31 106 56 105 31 31 31 31 31 31 31 31 31 31 31 31 31 31 31 31 31 31 31 31 31 31 31 31 32 34 34 34 34 34 34 34 34 34 34 34 34 34 34 34 34 253 102 102 102 102 102 102 226 227 176 34 34 34 34 34 34 34 34 34 34 34 34 34 34 34 34 34 34 34 34 202 278 130 82 156 156 156 156 156 156 156 156 156 156 156 156 295 156 156 156 156 83 131 131 131 131 131 131 131 82 156 156 83 131 132 102 102 102 102 102 102 102 102 102 102 102 102 164 165 165 165 165 241 191 102 102 102 235 185 76 76 76 76 76 76 76 183 184 184 184 234 102 102 102 102 102 102 160 76 76 76 76 76 76 76 76 76 133 209 102 102 102 102 102 164 165 165 165 165 165 165 165 165 165 165 165 165 165 165 165 165 165 165 166 102 102 102 102 102 102 102 102 102 102 102 102 102 102 102 102 102 102 102 102 276 277 277 277 277 277 277 277 277 277 277 277 277 277 277 277 277 277 278 102 102 102 102 102 102 102 102 226 176 34 34 34 34 34 34 34 5 80 31 31 31 31 31 32 34 34 34 34 253 102 102 102 102 102 102 102 102 102 102 102 102 333 139 215 165 165 165 165 165 
28 28 28 28 28 28 28 28 28 28 28 28 28 28 28 29 31 31 31 31 31 106 56 57 34 55 105 31 31 31 31 31 31 31 31 31 31 31 31 31 31 31 31 31 31 31 31 31 106 56 57 34 34 34 34 34 34 34 34 34 34 34 34 34 34 34 34 177 227 227 227 227 227 227 176 34 34 34 34 34 34 34 34 34 34 34 34 34 34 34 34 34 34 34 34 34 202 278 102 155 156 156 156 156 156 156 156 270 156 156 156 156 156 156 156 156 156 156 347 156 156 156 156 156 156 156 156 156 156 156 156 83 131 132 102 102 102 102 102 102 102 102 102 102 189 240 165 165 241 191 102 102 102 235 185 76 76 76 76 76 76 76 76 76 76 76 76 183 234 102 102 102 102 102 210 135 76 76 76 76 76 76 76 133 209 102 102 102 102 102 102 164 165 165 165 165 165 165 165 165 165 165 165 165 165 165 165 165 165 165 166 102 102 102 102 102 102 102 333 102 102 102 102 102 102 102 102 102 102 102 102 102 102 102 102 102 102 102 102 102 102 102 102 102 102 102 102 102 102 102 102 102 102 102 102 102 102 102 251 34 34 34 34 34 34 34 5 80 31 31 31 31 31 31 32 34 34 34 34 253 102 102 102 102 102 102 102 102 102 102 102 139 140 215 165 165 165 165 165 165 
28 28 28 28 28 28 28 28 28 28 28 28 28 28 28 29 31 31 31 31 106 57 34 34 34 34 55 105 31 31 31 31 31 31 31 31 31 31 31 31 31 31 31 31 31 31 106 56 57 34 34 34 34 34 34 34 34 34 34 34 34 34 34 34 34 34 34 34 34 34 34 34 34 34 34 34 34 34 34 34 34 34 34 34 34 34 34 34 34 34 34 34 34 34 34 34 253 102 102 155 156 156 156 156 156 156 156 156 156 156 156 156 156 156 156 346 156 156 156 156 156 156 156 156 156 156 156 156 156 156 156 156 156 83 132 102 102 322 102 102 102 102 102 102 102 189 190 190 191 102 102 102 235 185 76 23 24 24 24 24 25 76 76 76 76 76 76 76 183 234 102 102 102 102 102 210 135 76 76 76 76 133 134 209 102 102 102 333 102 102 102 164 165 165 165 165 165 165 165 165 165 165 165 165 165 165 165 165 165 165 166 102 102 102 102 102 102 102 102 102 102 102 102 102 102 102 102 102 102 102 102 102 102 102 333 102 102 102 102 102 102 102 102 102 102 102 102 102 102 102 102 102 102 102 102 102 102 226 176 34 34 34 34 34 34 34 30 31 31 31 31 31 31 31 32 34 34 34 34 253 102 102 102 102 102 102 102 102 102 102 139 215 165 165 165 165 165 165 165 165 
28 28 28 28 28 28 28 28 28 28 28 28 28 28 28 29 31 31 31 31 34 34 34 34 34 34 34 55 105 31 31 31 31 31 31 31 31 31 31 31 31 31 31 31 106 56 57 34 34 34 34 34 34 34 34 34 34 34 34 34 34 34 34 34 34 34 34 34 34 34 34 34 34 34 34 34 34 34 34 34 34 34 34 34 34 34 34 34 34 34 34 34 34 34 34 34 253 102 102 155 156 156 156 156 156 295 156 156 156 156 156 156 156 156 156 108 181 181 181 107 156 156 156 156 156 156 156 156 156 156 156 156 156 156 83 132 102 102 102 102 102 102 102 102 102 102 102 102 102 102 102 235 185 76 76 48 76 76 76 76 99 24 24 24 24 25 76 76 76 183 234 102 102 102 102 102 210 134 134 134 134 209 102 102 102 102 102 102 102 102 102 164 165 165 165 165 165 165 165 165 165 165 165 165 165 165 165 165 165 165 166 102 102 102 102 102 102 102 102 102 102 102 102 102 102 102 102 102 102 102 102 102 102 102 102 102 102 102 102 335 102 102 102 102 102 102 102 102 102 102 102 102 102 334 102 102 102 251 34 34 34 34 34 34 34 34 30 31 31 31 31 31 31 106 57 34 34 34 34 253 102 102 102 102 102 102 102 102 102 139 215 165 165 165 165 165 165 165 165 165 
28 28 28 28 28 28 28 28 28 28 28 28 28 28 104 54 31 31 31 31 81 7 34 34 34 34 34 34 55 56 56 56 105 31 31 31 106 56 56 56 56 56 56 56 57 34 34 34 34 34 34 34 34 34 34 34 34 34 34 34 34 34 34 34 34 34 34 34 34 34 34 34 34 34 34 34 34 34 34 34 34 34 34 34 34 34 34 34 34 34 34 34 34 34 34 202 278 102 102 180 107 156 156 346 156 156 156 345 156 156 156 156 156 156 108 182 102 102 102 155 156 156 156 156 156 156 270 156 156 156 156 156 156 156 156 83 132 102 102 102 102 102 102 102 102 102 102 102 102 102 235 185 76 76 24 48 76 76 20 22 76 76 76 76 24 50 76 76 76 76 158 102 102 102 102 102 102 102 102 102 102 102 102 102 102 334 102 102 102 102 102 189 190 240 165 165 165 165 165 165 165 165 165 165 165 165 165 165 165 241 191 102 102 102 102 102 102 102 102 102 102 102 102 102 102 102 102 102 102 102 102 102 102 102 102 102 102 102 102 102 102 102 102 102 102 102 102 102 102 102 102 102 102 102 102 102 102 251 34 34 34 34 34 34 34 34 30 31 31 31 31 31 106 57 34 34 34 34 202 278 102 102 102 102 102 102 102 102 139 215 165 165 165 165 165 165 165 165 165 165 
28 28 28 28 28 28 28 28 28 28 28 28 104 53 54 31 31 31 31 31 31 32 34 34 34 34 34 34 34 34 34 34 55 56 56 56 57 34 34 34 34 34 34 34 34 34 34 34 34 34 34 34 34 34 34 34 34 34 34 34 34 34 34 34 34 34 34 34 34 34 34 34 34 34 34 34 34 34 34 34 34 34 34 34 34 34 34 34 34 34 34 34 34 34 202 278 102 102 320 102 155 156 156 156 156 156 156 156 156 156 156 156 156 108 182 102 102 102 102 180 107 156 156 156 156 156 156 156 156 156 156 156 156 156 156 156 157 102 102 359 301 329 301 329 301 329 358 102 102 102 160 76 76 48 24 76 76 20 96 97 22 76 76 76 24 50 76 76 76 76 158 102 102 102 102 102 102 102 102 102 102 102 102 102 102 102 102 102 102 102 102 102 102 189 190 190 240 165 165 165 165 165 165 165 165 165 165 165 241 191 102 102 102 102 102 102 102 102 102 102 102 102 102 102 102 102 102 102 102 102 102 102 102 102 102 102 102 102 102 102 102 102 102 102 336 102 102 102 102 102 102 102 102 102 102 102 102 251 34 34 34 34 34 34 34 34 55 56 56 56 56 56 57 34 34 34 34 34 253 102 102 102 102 102 102 102 102 102 164 165 165 165 165 165 165 165 165 165 165 165 
53 53 53 53 53 53 103 28 104 53 53 53 54 31 31 31 31 31 31 31 31 32 34 34 34 34 34 34 34 34 34 34 34 34 34 34 34 34 34 34 34 34 34 34 34 34 34 34 34 34 34 34 34 34 34 34 34 34 34 34 34 34 34 34 34 34 34 34 34 34 34 34 34 34 34 34 34 34 34 34 34 34 34 34 34 34 34 34 34 34 34 34 34 202 278 102 102 102 102 102 180 181 107 156 156 156 156 156 156 156 270 156 156 157 102 102 102 102 102 102 180 107 156 156 156 156 156 156 156 156 345 156 156 156 156 156 157 102 102 384 351 379 351 379 351 379 383 102 333 102 160 76 76 48 76 76 76 70 121 122 72 76 76 76 24 50 76 76 76 76 158 102 102 334 102 102 333 102 102 102 102 102 102 235 184 184 184 234 102 102 102 333 102 102 102 102 164 165 165 165 165 165 165 165 165 165 241 190 191 102 102 102 102 102 102 257 258 258 258 258 258 258 258 258 258 258 259 102 102 102 102 102 102 102 102 102 102 102 102 102 102 102 102 102 102 102 102 102 102 102 102 102 102 102 102 102 102 251 34 34 34 34 34 34 34 34 34 34 34 34 34 34 34 34 34 34 34 202 278 102 102 102 102 102 102 102 102 102 164 165 165 165 165 165 165 165 165 165 165 165 
31 31 31 31 31 31 52 53 54 31 31 31 31 31 31 31 31 31 31 31 31 32 34 34 34 34 34 34 34 34 34 34 34 34 34 34 34 34 34 34 34 34 34 34 34 34 34 34 34 34 34 34 34 34 34 34 34 34 34 34 34 34 34 34 34 34 34 34 34 34 34 34 34 34 34 34 34 34 34 34 34 34 34 34 34 34 34 34 34 34 34 34 202 278 102 102 102 102 102 102 102 102 180 107 156 156 156 295 156 156 156 156 156 83 132 102 102 320 102 102 102 155 156 156 156 347 156 156 295 156 156 156 156 156 156 156 157 102 102 102 102 102 102 102 102 102 102 102 102 102 160 76 76 73 74 123 76 76 70 72 76 76 24 74 74 75 76 76 76 76 158 102 102 102 102 102 102 102 102 102 235 184 184 185 76 76 76 183 234 102 102 102 102 102 102 102 189 240 165 165 165 165 241 190 190 190 191 102 102 102 102 257 258 258 258 233 102 102 102 102 102 102 102 102 102 102 208 258 258 258 258 258 258 258 258 258 258 259 102 102 102 102 102 102 102 102 102 102 102 102 102 102 102 102 102 102 102 251 34 34 34 34 34 34 34 34 34 34 34 34 34 34 34 34 34 34 202 278 102 102 102 102 102 102 102 102 102 102 164 165 165 165 165 165 165 165 165 165 165 165 
31 31 31 31 31 31 31 31 31 31 31 31 31 31 31 31 31 31 31 31 31 32 34 34 34 34 34 34 34 34 34 34 34 34 34 34 34 34 34 34 34 34 34 34 34 34 34 34 34 34 34 34 34 34 34 34 34 34 34 34 34 34 34 34 34 34 34 34 34 34 34 34 34 34 34 34 34 34 34 34 34 34 34 34 34 34 34 34 34 34 34 202 278 102 102 102 102 102 102 102 320 102 102 155 156 156 156 156 156 156 156 156 156 156 157 102 102 102 102 322 102 180 107 156 156 156 156 156 156 156 156 156 270 156 156 156 157 102 102 102 102 102 102 102 102 102 102 102 102 102 160 76 76 76 76 73 74 74 74 74 74 74 74 75 76 76 76 76 76 76 158 102 102 102 102 102 102 235 184 184 185 76 76 76 76 76 76 76 183 184 234 102 102 102 102 102 102 189 190 190 190 190 191 102 102 102 102 102 102 102 257 233 102 102 102 102 102 102 102 102 102 102 102 102 102 102 102 102 102 102 102 102 102 102 102 102 102 208 258 258 259 102 102 102 102 102 102 102 335 102 102 102 102 102 102 102 102 276 201 34 34 34 34 34 34 34 34 34 34 34 34 34 34 34 202 277 278 102 102 102 102 102 102 102 102 102 102 102 164 165 165 165 165 165 165 165 165 165 165 165 
31 31 31 31 31 31 31 31 31 31 31 31 31 31 31 31 31 31 31 31 31 32 34 34 34 34 34 34 34 34 34 34 34 34 34 34 34 34 34 34 34 34 34 34 34 34 34 34 34 34 34 34 34 34 34 34 34 34 34 34 34 34 34 34 34 34 34 34 34 34 34 34 34 34 34 34 34 34 34 34 34 34 34 34 34 34 34 34 34 34 202 278 102 102 102 102 102 102 322 102 102 102 102 180 107 156 156 156 156 156 156 156 156 156 157 102 102 102 102 102 102 102 155 156 156 156 156 156 156 156 156 156 156 156 156 108 182 322 102 102 102 102 102 322 102 102 102 102 102 102 210 135 76 76 76 76 76 76 76 76 76 76 76 76 76 76 76 76 76 133 209 102 102 102 102 102 235 185 76 76 76 76 76 76 76 76 76 76 76 76 158 102 102 334 102 102 102 102 102 102 102 102 102 102 102 102 102 102 257 258 233 102 102 102 102 102 102 102 102 102 102 102 102 102 102 102 102 102 102 102 102 102 102 102 333 102 102 102 102 102 208 259 102 102 102 102 102 102 102 102 102 102 102 102 102 102 102 102 251 34 34 34 34 34 34 34 34 34 34 34 34 34 202 277 278 102 102 102 102 102 102 102 102 102 102 102 102 102 189 240 165 165 165 165 165 165 165 165 165 165 
31 31 31 31 31 31 31 31 31 31 31 31 31 31 31 31 31 31 31 31 31 32 34 34 34 34 34 34 34 34 34 34 34 34 34 34 34 34 34 34 34 34 34 34 34 34 34 34 34 34 34 34 34 34 34 34 34 34 34 34 34 34 34 34 34 34 34 34 34 34 34 34 34 34 34 34 34 34 34 34 34 34 34 34 34 34 34 34 34 202 278 102 102 102 102 102 102 102 102 102 102 102 102 102 155 156 156 295 156 156 347 156 156 156 157 102 102 102 102 102 102 102 180 107 156 295 156 156 346 156 156 156 156 156 156 157 102 102 102 102 102 102 102 102 102 102 102 102 102 102 102 210 134 135 76 76 76 76 76 76 76 76 76 76 76 76 76 76 133 209 102 102 102 102 102 235 185 76 76 76 76 76 342 343 343 343 344 76 76 76 158 102 102 102 102 102 102 102 102 102 102 102 102 102 102 102 102 257 233 102 102 102 102 102 102 102 102 102 139 140 140 140 140 140 140 140 140 140 140 140 140 141 102 102 102 102 102 102 102 102 102 208 258 259 102 102 102 102 102 102 102 102 102 102 102 102 102 102 276 277 277 201 34 34 34 34 34 202 277 277 277 277 278 102 102 102 102 102 102 102 139 140 140 140 140 140 141 102 102 189 240 165 165 165 165 165 165 165 165 165 
31 31 31 31 31 31 31 31 31 31 31 31 31 31 31 31 31 31 31 31 106 57 34 34 34 34 34 34 34 34 34 34 34 34 34 34 34 34 34 34 34 34 34 34 34 34 34 34 34 34 34 34 34 34 34 34 34 34 34 34 34 34 34 34 34 34 34 34 34 34 34 34 34 34 34 34 34 34 34 34 34 34 34 34 34 34 34 34 202 278 102 102 102 102 320 102 102 102 102 102 102 321 102 130 82 156 156 156 156 156 156 156 156 156 157 102 102 102 321 102 102 102 102 180 107 156 156 156 156 156 156 108 181 181 181 182 102 102 102 102 102 102 102 102 102 102 102 102 102 102 102 102 102 210 134 135 76 76 76 76 76 76 76 76 76 76 133 134 209 102 102 102 102 235 184 185 76 76 76 76 76 342 128 289 289 289 129 344 76 76 158 102 102 102 102 102 102 102 102 102 102 102 102 102 102 257 258 233 102 102 333 102 102 102 102 102 139 140 215 165 165 165 165 165 165 165 165 165 165 165 165 216 140 140 141 102 102 102 102 102 102 102 102 208 258 259 102 102 102 102 102 102 102 102 102 102 102 102 102 102 102 276 277 277 277 277 277 278 102 102 102 102 102 102 102 102 102 102 102 102 164 165 165 165 165 165 216 141 334 102 189 240 165 165 165 165 165 165 165 165 
31 31 31 31 31 31 31 31 31 31 31 31 31 31 31 31 31 31 31 106 57 34 34 34 34 34 34 34 34 34 34 34 34 34 34 34 34 34 34 34 34 34 34 34 34 34 34 34 34 34 34 34 34 34 34 34 34 34 34 34 34 34 34 34 34 34 34 34 34 34 34 34 34 34 34 34 34 34 34 34 34 34 34 34 34 34 202 277 278 102 102 102 102 102 102 102 102 102 102 102 102 102 102 155 156 156 156 156 156 156 156 156 108 181 182 102 102 102 102 102 102 102 102 102 180 181 181 181 181 181 181 182 102 102 102 102 226 227 227 227 227 227 227 227 227 227 227 227 228 102 102 102 102 102 102 210 134 134 134 134 134 134 134 134 134 134 209 102 102 102 102 102 235 185 76 76 76 76 76 76 342 128 289 289 289 289 289 369 76 76 183 184 184 184 234 102 102 102 102 102 102 102 102 102 257 233 102 102 102 102 102 102 102 102 139 140 215 165 165 165 165 165 165 165 165 165 165 165 165 165 165 165 165 165 216 140 140 141 102 102 102 102 102 102 102 208 259 102 102 102 102 102 102 102 102 102 102 102 102 102 102 102 102 102 102 102 102 102 102 335 102 102 102 102 102 102 102 102 102 139 215 165 165 165 165 165 165 216 140 140 141 164 165 165 165 165 165 165 165 165 
31 31 31 31 31 31 31 31 31 31 31 31 31 31 31 31 31 106 56 57 34 34 34 34 34 34 34 34 34 34 34 34 34 34 34 34 34 34 34 34 34 34 34 34 34 34 34 34 34 34 34 34 34 34 34 34 34 34 34 34 34 34 34 34 34 34 34 34 34 34 34 34 34 34 34 34 34 34 34 34 34 34 34 34 202 277 278 102 102 102 102 102 102 102 102 102 102 321 102 102 102 102 102 155 156 156 156 156 345 156 156 108 182 102 102 320 102 102 102 102 102 102 102 102 102 102 102 102 102 102 102 102 102 102 102 226 176 202 277 277 277 277 277 277 277 277 277 201 177 228 102 102 102 102 102 102 102 102 102 102 102 102 102 102 102 102 102 102 102 102 102 235 185 76 76 76 76 76 342 343 128 337 338 338 338 289 289 129 343 344 76 76 76 76 158 102 102 102 102 102 102 102 102 257 233 102 102 102 102 102 102 102 139 140 215 165 165 165 165 165 165 165 165 165 165 165 165 165 165 165 165 165 165 165 165 165 165 216 141 102 102 102 102 102 102 102 208 258 259 102 102 102 102 102 102 102 102 102 102 102 102 102 102 102 102 102 102 102 102 102 102 102 102 102 102 333 102 102 102 164 165 165 165 165 165 165 165 165 165 165 216 215 165 165 165 165 165 165 165 165 
31 31 31 31 31 31 31 31 31 31 31 31 31 31 31 31 106 57 34 34 34 34 34 34 34 34 34 34 34 34 34 34 34 34 34 34 34 34 34 34 34 34 34 34 34 34 34 34 34 34 34 34 34 34 34 34 34 34 34 34 34 34 34 34 34 34 34 34 34 34 34 34 34 34 34 34 34 34 34 202 277 277 277 277 278 102 102 102 102 102 102 322 102 102 102 102 102 102 102 102 322 102 102 180 181 107 156 156 156 156 156 157 102 102 102 102 102 102 102 102 102 102 320 102 102 102 102 102 102 102 102 102 322 102 226 176 202 278 102 102 102 102 102 102 102 102 102 276 201 177 228 102 102 102 334 102 102 102 102 102 102 102 102 333 102 102 102 102 102 102 235 185 76 76 76 76 76 342 128 289 337 340 363 363 363 341 339 289 289 129 344 76 76 76 183 234 102 102 102 102 102 102 257 233 102 102 102 102 102 139 140 140 215 165 165 165 165 165 165 165 165 165 165 165 165 165 165 165 165 165 165 165 165 165 165 165 165 165 216 141 102 102 102 102 102 102 102 102 208 259 102 102 102 102 102 359 301 329 301 329 301 329 301 329 301 329 301 329 301 329 358 102 102 102 102 102 102 102 102 164 165 165 165 165 165 165 165 165 165 165 165 165 165 165 165 165 165 165 165 165 
31 31 31 31 31 31 31 31 31 31 31 31 31 31 31 106 57 34 34 34 34 34 34 34 34 34 34 34 34 34 34 34 34 34 34 34 34 34 34 34 34 34 34 34 34 34 34 34 34 34 34 34 34 34 34 34 34 34 34 34 34 34 34 34 34 34 34 34 34 34 34 34 34 34 34 34 34 34 202 278 102 102 102 102 102 102 102 102 102 102 102 102 102 102 102 102 102 102 102 102 102 102 102 102 102 248 193 193 193 193 193 125 102 102 102 102 102 102 102 102 102 102 102 102 102 102 102 321 102 102 102 102 102 226 176 202 278 102 102 102 322 102 322 102 102 321 102 102 276 201 177 228 102 102 102 102 102 102 102 102 102 102 102 102 102 102 102 102 102 235 185 76 76 76 76 76 342 128 289 289 362 363 363 363 363 363 341 339 289 289 369 76 76 76 76 158 102 102 102 102 102 257 233 102 102 102 102 102 102 215 165 165 165 165 165 165 165 165 165 165 165 165 165 165 165 165 165 165 165 165 165 165 165 165 165 165 165 165 165 216 141 102 102 334 102 102 102 102 102 208 259 102 102 102 102 384 351 379 351 379 351 379 351 379 351 379 351 379 351 379 383 102 102 102 102 102 102 102 102 164 165 165 165 165 165 165 165 165 165 165 165 165 165 165 165 165 165 165 165 165
