20x20.bmp 250:24
37 37 37 37 5 80 31 31 31 31 31 31 31 31 31 31 31 31 31 31 31 31 31 31 31 31 31 31 31 31 6 7 37 37 37 37 37 37 37 37 37 37 37 37 37 37 37 37 37 37 37 37 37 37 37 37 37 37 37 37 37 5 6 6 6 6 6 6 6 6 6 6 6 6 6 6 80 31 31 31 31 31 31 31 31 31 31 31 27 28 28 28 28 28 28 79 4 31 31 31 31 31 31 31 31 31 81 6 7 37 37 37 37 286 286 287 1 1 1 1 1 1 1 1 1 1 1 1 1 1 1 1 254 37 37 37 37 37 37 37 37 37 37 37 37 37 37 37 37 37 37 37 37 37 37 37 37 37 37 37 37 37 37 37 37 37 37 37 37 37 37 37 37 37 37 37 37 37 37 37 37 37 37 37 37 37 37 37 37 37 37 5 6 7 37 37 37 37 37 37 37 37 87 13 37 37 253 102 102 102 164 165 166 102 164 165 166 102 102 189 190 191 102 321 102 102 102 102 102 215 165 165 165 216 141 102 102 102 102 102 102 102 102 102 102 102 102 102 164 165 
37 37 37 37 30 31 31 31 31 31 31 31 31 31 31 31 31 31 31 31 31 31 31 31 31 31 31 31 31 31 31 81 6 6 6 7 37 37 37 37 37 37 37 37 37 37 37 37 37 37 37 37 37 37 37 37 37 37 5 6 6 80 31 31 31 31 31 31 31 31 31 31 31 31 31 31 31 31 31 31 31 31 31 31 31 31 31 31 27 28 28 28 28 28 28 28 79 4 31 31 31 31 31 31 31 31 31 31 81 7 37 37 37 37 286 212 262 1 1 1 1 1 1 1 1 1 1 1 1 1 229 230 178 37 37 37 37 37 37 37 37 37 37 37 37 37 37 37 37 37 37 37 37 37 37 37 202 277 277 277 277 277 277 277 277 277 277 201 37 37 37 37 37 37 37 37 37 37 37 37 37 37 37 37 37 37 37 37 37 5 6 80 31 81 6 6 7 37 37 37 37 37 37 87 13 37 177 227 227 228 189 190 191 321 189 190 191 102 102 102 102 102 102 102 102 102 102 102 215 165 165 165 165 165 216 140 141 102 102 321 102 102 102 102 102 102 102 102 189 190 
37 37 37 5 80 31 31 31 31 31 31 31 31 31 31 31 31 31 31 31 31 31 31 31 31 31 31 31 31 31 31 31 31 31 31 81 6 6 6 6 6 6 6 7 37 37 37 5 6 6 6 6 6 6 6 6 6 6 80 31 31 31 31 31 31 31 31 31 31 31 31 31 31 31 31 31 31 31 31 31 31 31 31 31 31 31 31 31 27 28 28 28 28 28 28 28 28 29 31 31 31 31 31 31 31 31 31 31 31 81 7 37 37 37 37 286 212 262 1 1 1 1 1 1 1 1 1 1 1 229 178 37 37 37 37 37 37 37 37 37 37 37 37 37 37 37 37 37 37 37 37 37 37 37 37 202 278 139 140 141 283 283 283 283 139 140 141 276 201 37 37 37 37 37 37 37 37 37 37 37 37 37 37 37 37 37 37 37 37 30 31 31 31 31 31 31 32 37 37 37 37 37 37 37 87 13 37 87 13 177 227 228 102 102 102 102 102 320 102 102 102 102 102 102 102 102 215 165 165 165 165 165 165 165 165 165 216 141 102 102 102 102 102 102 320 102 102 102 102 139 
37 37 5 80 31 31 31 31 31 31 31 31 31 31 31 31 31 31 31 31 31 31 31 31 31 31 31 31 31 31 31 31 31 31 31 31 31 31 31 31 31 31 31 81 6 7 5 80 31 31 31 31 31 31 31 31 31 31 31 31 31 31 31 31 31 31 31 31 31 31 31 31 31 31 31 31 31 31 31 31 31 31 31 31 31 31 31 31 27 28 28 28 28 28 28 28 28 29 31 31 31 31 31 31 31 31 31 31 31 31 32 37 37 286 37 37 286 212 261 261 262 1 1 1 229 230 230 230 230 178 37 37 37 37 37 37 37 37 37 37 37 37 37 37 37 37 37 37 37 37 37 37 37 37 37 253 283 164 165 166 283 283 283 283 164 165 166 283 276 201 37 37 37 37 37 37 37 37 37 37 37 37 37 37 37 37 37 37 37 30 31 31 31 31 31 31 32 37 37 37 37 37 37 37 37 87 13 37 87 13 37 177 228 102 102 102 102 102 102 102 102 322 102 102 102 164 165 165 165 165 165 165 165 165 165 165 165 216 141 102 102 102 102 102 102 102 102 321 102 164 
37 37 30 31 31 31 31 31 31 31 31 31 31 31 31 31 31 31 31 31 31 31 31 31 31 31 31 31 31 31 31 31 31 31 31 31 31 31 31 31 31 31 31 31 31 81 80 31 31 31 31 31 31 31 31 31 31 31 31 31 31 31 31 31 31 31 31 31 31 31 31 31 31 31 31 31 31 31 31 31 31 31 31 31 31 31 31 31 27 28 28 28 28 28 28 28 28 29 31 31 31 31 31 31 31 31 31 31 31 31 32 37 37 37 37 37 37 286 286 286 212 261 261 261 178 37 37 37 37 37 37 37 37 37 37 37 37 37 37 37 37 37 37 37 37 37 37 37 37 37 37 37 37 37 37 253 283 189 190 191 283 283 283 283 189 190 191 283 283 276 201 37 37 37 37 37 37 37 37 37 37 37 37 37 37 37 37 37 37 30 31 31 31 31 31 31 32 37 37 37 37 37 37 37 37 37 87 13 37 87 13 37 177 228 102 102 102 102 102 322 102 102 102 102 102 164 165 165 165 165 165 165 165 165 165 165 165 165 166 102 102 102 102 335 102 102 102 102 102 189 
37 37 30 31 31 31 31 31 2 3 3 3 3 4 31 31 31 31 31 31 31 31 31 31 31 31 31 31 31 31 31 31 31 31 31 31 31 31 31 31 31 31 31 31 31 31 31 31 31 31 31 31 31 31 31 31 31 2 3 3 3 3 3 3 3 4 31 31 31 31 31 31 31 31 31 31 31 31 31 31 31 31 31 31 31 31 31 2 78 28 28 28 28 28 28 28 28 29 31 31 31 31 31 31 31 31 31 31 31 31 81 7 37 37 37 37 37 37 286 286 286 37 286 37 37 37 37 37 37 37 37 37 37 37 37 37 37 37 37 37 37 37 37 37 37 37 37 37 37 37 37 37 37 37 37 177 228 283 283 283 283 139 140 141 283 283 283 283 283 283 276 201 37 37 37 37 37 37 37 37 37 37 37 37 37 37 37 37 37 55 105 31 31 31 31 31 32 37 37 37 37 37 37 37 37 37 37 87 13 37 87 13 37 177 228 102 102 102 102 102 102 102 102 102 102 189 240 165 165 165 165 165 165 165 165 165 165 165 166 102 102 102 102 102 102 336 102 102 102 102 
37 37 30 31 31 31 31 31 27 28 28 28 28 29 31 31 31 31 31 31 31 31 31 31 31 31 31 31 31 31 31 31 31 31 31 31 2 3 3 3 3 3 3 3 3 3 3 3 4 31 31 31 31 31 31 31 2 78 28 28 28 28 28 28 28 79 4 31 31 31 31 31 31 31 31 31 31 31 31 31 31 31 31 31 31 31 2 78 28 28 28 28 28 28 28 28 28 29 31 31 31 31 31 31 31 31 31 31 31 31 31 32 37 37 37 286 37 37 37 286 37 37 37 37 37 37 37 37 37 37 37 37 37 37 37 37 37 37 37 37 37 37 37 37 37 37 37 37 37 37 37 37 37 37 37 37 253 283 283 283 283 164 165 166 283 283 283 139 140 141 283 251 37 37 37 37 37 37 37 37 37 37 37 37 37 37 37 37 37 37 30 31 31 31 31 31 81 7 37 37 37 37 37 37 37 37 37 37 87 13 37 87 13 37 177 228 102 102 102 102 102 139 140 141 102 102 189 240 165 165 165 165 165 165 165 165 165 165 166 102 139 140 141 102 102 102 102 102 139 140 
37 5 80 31 31 31 31 31 27 28 28 28 28 79 3 3 3 4 31 31 31 31 31 31 31 31 31 31 31 31 31 31 31 31 2 3 78 28 28 28 28 28 28 28 28 28 28 28 79 3 4 31 31 31 2 3 78 28 28 28 28 28 28 28 28 28 29 31 31 31 31 31 31 31 2 3 3 4 31 31 31 31 31 31 31 2 78 28 28 28 28 28 28 28 28 28 28 29 31 31 31 31 31 31 31 31 31 31 31 31 31 32 37 37 37 37 37 37 37 37 37 286 37 37 37 37 37 37 37 37 37 37 37 37 37 37 37 37 37 37 37 37 37 37 37 37 37 37 37 37 37 37 37 37 37 37 177 227 228 283 283 189 190 191 283 283 283 164 165 166 283 251 37 37 37 37 37 37 37 37 37 37 37 37 37 37 37 37 37 37 30 31 31 31 31 31 31 81 7 37 37 37 37 37 37 37 37 37 37 87 13 37 87 13 37 177 228 102 102 102 102 164 165 166 102 102 102 189 240 165 165 165 165 165 165 165 241 190 191 102 164 165 166 102 102 102 102 320 164 165 
37 30 31 31 31 31 31 31 27 28 28 28 28 28 28 28 28 79 3 3 4 31 31 31 31 31 31 31 31 31 31 31 31 2 78 28 28 28 28 28 28 28 28 28 28 28 28 28 28 28 79 3 4 2 78 28 28 28 28 28 28 28 28 28 28 28 79 4 31 31 2 3 3 3 78 28 28 79 3 3 3 3 3 3 3 78 28 28 28 28 28 28 28 28 28 28 28 29 31 31 31 31 31 31 31 31 31 31 31 31 31 32 37 37 37 37 37 286 37 37 37 37 37 37 37 37 37 37 37 37 37 37 37 37 37 37 37 37 37 37 37 37 37 37 37 37 37 37 37 37 37 37 37 37 37 37 37 37 177 228 283 283 283 283 283 283 283 189 190 191 283 251 37 37 37 37 37 37 37 37 37 37 37 37 37 37 37 37 37 37 55 105 31 31 31 31 31 31 32 37 37 37 37 37 37 37 37 37 37 37 87 13 37 87 13 37 177 227 228 102 102 189 190 191 102 102 102 102 189 190 240 165 165 165 165 241 191 102 102 102 189 190 191 102 102 102 102 102 189 190 
37 30 31 31 31 31 31 31 27 28 28 28 28 28 28 28 28 28 28 28 79 3 3 3 3 3 3 3 3 3 3 3 3 78 28 28 28 28 28 28 28 28 28 28 28 28 28 28 28 28 28 28 79 78 28 28 28 28 28 28 28 28 28 28 28 28 28 79 3 3 78 28 28 28 28 28 28 28 28 28 28 28 28 28 28 28 28 28 28 28 28 28 28 28 28 28 104 54 31 31 31 31 31 31 31 31 31 31 31 31 31 32 37 37 37 37 37 37 37 37 286 37 37 37 37 37 37 37 37 37 37 37 37 37 37 37 37 37 37 37 37 37 37 37 37 37 37 37 37 37 37 37 37 37 37 37 37 37 37 177 228 283 283 283 283 283 283 283 283 283 226 176 37 37 37 37 37 37 37 37 37 37 37 37 37 37 37 37 37 37 37 30 31 31 31 31 31 31 81 7 37 37 37 37 37 37 37 37 37 37 37 87 13 37 87 13 37 37 177 228 102 102 102 102 102 102 102 102 102 102 189 190 190 190 190 191 102 102 102 102 102 102 102 102 102 102 102 102 102 102 
37 30 31 31 31 31 31 31 27 28 28 28 28 28 28 28 28 28 28 28 28 28 28 28 28 28 28 28 28 28 28 28 28 28 28 28 28 28 28 28 28 28 28 28 28 28 28 28 28 28 28 28 28 28 28 28 28 28 28 28 28 28 28 28 28 28 28 28 28 28 28 28 28 28 28 28 28 28 28 28 28 28 28 28 28 28 28 28 28 28 28 28 28 28 28 28 29 31 31 31 31 31 31 31 31 31 31 31 31 31 31 32 37 37 37 37 37 37 37 37 37 37 37 37 37 37 37 37 37 37 37 37 37 37 37 37 37 37 37 37 37 37 37 37 37 202 277 277 277 277 277 201 37 37 37 37 37 37 37 37 177 227 227 228 283 283 283 283 283 226 176 37 37 37 37 37 37 37 37 37 37 37 37 37 37 37 37 37 37 37 37 55 105 31 31 31 31 31 31 32 37 37 37 37 37 37 37 37 37 37 37 37 87 13 37 87 13 37 37 177 228 102 102 102 139 140 141 102 102 102 102 102 102 139 140 141 102 102 102 102 235 184 184 184 184 184 184 234 102 102 
37 30 31 31 31 31 31 31 27 28 28 28 28 28 28 28 28 28 28 28 28 28 28 28 28 28 28 28 28 28 28 28 28 28 28 28 28 28 28 28 28 28 28 28 28 28 28 28 28 28 28 104 53 53 53 103 28 28 28 28 28 28 28 28 28 28 28 28 28 28 28 28 28 28 28 28 28 28 28 28 28 28 28 28 28 28 28 28 28 28 28 28 28 28 28 104 54 31 31 31 31 31 31 31 31 31 31 31 31 31 31 32 37 37 37 37 286 37 37 37 37 37 37 37 37 37 37 37 37 37 37 37 37 37 37 37 37 37 37 37 37 37 37 37 37 253 283 283 283 283 283 251 37 37 37 37 37 37 37 37 37 37 37 177 227 227 227 227 227 176 37 37 37 37 37 37 37 37 37 37 37 37 37 37 37 37 37 37 37 37 37 37 55 105 31 31 31 31 31 32 37 37 37 37 37 37 37 37 37 37 37 37 37 87 13 37 87 13 37 37 253 102 102 102 164 165 166 322 102 102 139 140 141 164 165 166 102 320 102 102 160 76 76 76 76 76 76 158 102 102 
37 30 31 31 31 31 31 31 52 103 28 28 28 28 28 28 28 28 28 28 28 28 28 28 28 28 28 28 28 28 28 28 28 28 28 28 28 28 28 28 28 28 28 28 28 28 28 28 28 104 53 54 31 31 31 52 103 28 28 28 28 28 28 28 28 28 28 28 28 28 28 28 28 28 28 28 28 28 28 28 28 28 28 28 28 28 28 28 28 28 28 28 28 28 28 29 31 31 31 31 31 31 31 31 31 31 31 31 31 31 31 32 37 37 37 37 37 37 37 37 37 37 37 37 37 37 37 37 37 37 37 37 37 37 37 37 37 37 37 37 37 37 37 37 202 278 283 139 140 141 283 251 37 37 37 37 37 37 37 37 37 37 37 37 37 37 37 37 37 37 37 37 37 37 37 37 37 37 37 37 37 37 37 37 37 37 37 37 37 37 37 37 37 55 105 31 31 31 31 81 7 37 37 37 37 37 37 37 37 37 37 37 37 37 87 13 37 87 13 37 177 228 102 102 189 190 191 102 102 102 164 165 166 189 190 191 102 102 235 184 185 76 76 76 76 76 76 158 102 102 
37 55 105 31 31 31 31 31 31 52 53 53 103 28 28 28 28 28 28 28 28 28 28 28 28 28 28 28 28 28 28 28 28 28 28 28 28 28 28 28 28 28 28 28 28 28 28 28 104 31 31 31 31 31 31 31 52 103 28 28 28 28 28 28 28 28 28 28 28 28 28 28 28 28 28 28 28 28 28 28 28 28 28 28 28 28 28 28 28 28 28 28 28 28 104 54 31 31 31 31 31 31 31 31 31 31 31 31 31 31 31 32 37 37 37 37 37 37 37 37 37 37 37 37 37 37 37 37 37 37 37 37 37 37 37 37 37 37 37 37 37 37 37 37 253 283 283 164 165 166 283 251 37 37 37 37 37 37 37 37 37 37 37 37 37 37 37 37 37 37 37 37 37 37 37 37 37 37 37 37 37 37 37 37 37 37 37 37 37 37 37 37 37 37 30 31 31 31 31 31 32 37 37 37 37 37 37 37 37 37 37 37 37 37 37 87 13 37 87 13 37 177 227 228 102 102 102 102 102 102 189 190 191 102 102 102 102 102 160 76 76 76 76 76 76 76 76 183 234 102 
37 37 30 31 31 31 31 31 31 31 31 31 52 53 53 53 103 28 28 28 28 28 28 28 28 28 28 28 28 28 28 28 28 28 28 28 28 28 28 28 28 28 28 28 28 28 104 53 54 31 31 31 31 31 31 31 31 52 53 103 28 28 28 28 28 28 28 28 28 28 28 28 28 28 28 28 28 28 28 28 28 28 28 28 28 28 28 28 28 28 28 28 28 28 29 31 31 31 31 31 31 31 31 31 31 31 31 31 31 31 31 32 37 37 37 37 37 37 37 37 37 37 37 37 243 317 317 317 317 317 317 242 37 37 37 37 37 37 37 37 37 37 37 37 177 228 283 189 190 191 283 251 37 37 37 37 37 37 37 37 37 37 37 37 37 37 37 37 37 37 37 37 37 37 37 37 37 37 37 37 37 37 37 37 37 37 37 37 37 37 37 37 37 37 55 105 31 31 31 31 81 7 37 37 37 37 37 37 37 37 37 37 37 37 37 37 87 13 37 87 13 37 37 177 228 322 102 102 102 320 102 102 102 102 102 102 102 102 160 76 76 76 76 76 76 76 76 76 158 102 
37 37 30 31 31 31 31 31 31 31 31 31 31 31 31 31 52 53 53 53 53 53 53 53 53 53 103 28 28 28 28 28 28 28 28 28 28 28 28 28 28 28 104 53 53 53 54 31 31 31 31 31 31 31 31 31 31 31 31 52 103 28 28 28 28 28 28 28 28 28 28 28 28 28 28 28 28 28 28 28 28 28 28 28 28 28 28 28 28 28 28 28 28 104 54 31 31 31 31 31 31 31 31 31 31 31 31 31 31 31 106 57 37 37 37 37 37 37 37 37 37 37 243 317 318 26 26 26 26 26 26 316 317 242 37 37 37 37 37 37 37 37 37 37 37 177 227 228 283 283 283 251 37 37 37 37 37 37 37 37 37 37 37 37 37 37 37 37 37 37 37 37 37 37 37 37 37 37 37 37 37 37 37 37 37 37 37 37 37 37 37 37 37 37 37 30 31 31 31 31 31 32 37 37 37 37 37 37 37 37 37 37 37 37 37 37 37 87 13 37 87 13 37 37 253 102 102 102 102 102 102 102 102 102 322 102 102 102 160 76 76 76 76 76 76 76 76 76 158 102 
37 37 55 105 31 31 31 31 31 31 31 31 31 31 31 31 31 31 31 31 31 31 31 31 31 31 52 53 53 53 53 53 53 53 53 53 53 53 53 53 53 53 54 31 31 31 31 31 31 31 31 31 31 31 31 31 31 31 31 31 52 53 53 53 53 103 28 28 28 28 28 28 28 28 28 28 28 28 28 28 28 28 28 28 28 28 28 28 28 28 28 28 104 54 31 31 31 31 31 31 31 31 31 31 31 31 31 31 31 106 57 37 37 37 37 37 37 37 37 37 37 243 318 26 26 26 26 26 26 26 26 26 26 316 242 37 37 37 37 37 37 37 37 37 37 37 37 177 227 227 227 176 37 37 37 37 37 37 37 37 37 37 37 37 37 37 37 37 202 277 277 277 277 201 37 37 37 37 37 37 37 37 37 37 37 37 37 37 37 37 37 37 37 37 37 55 105 31 31 31 31 32 37 37 37 37 37 37 37 37 37 37 37 37 37 37 37 37 87 13 37 87 13 37 177 228 102 102 102 102 102 102 102 102 102 102 102 102 160 76 76 76 76 76 76 76 76 133 209 102 
37 37 37 55 56 56 105 31 31 31 31 31 31 31 31 31 31 31 31 31 31 31 31 31 31 31 31 31 31 31 31 31 31 31 31 31 31 31 31 31 31 31 31 31 31 31 31 31 31 31 31 31 31 31 31 31 31 31 31 31 31 31 31 31 31 52 53 53 53 53 53 53 53 53 53 53 53 53 53 53 53 53 53 53 53 53 53 53 53 53 53 53 54 31 31 31 31 31 31 31 31 31 31 31 31 31 31 31 31 32 37 37 37 37 37 37 37 37 37 37 243 318 26 26 26 14 15 15 16 26 26 26 26 26 316 242 37 37 37 37 37 37 37 37 37 37 37 37 37 37 37 37 37 37 37 37 37 37 37 37 37 37 37 37 37 37 37 202 278 139 140 141 283 276 277 201 37 37 37 37 37 37 37 37 37 37 37 37 37 37 37 37 37 37 37 37 30 31 31 31 31 32 37 37 37 37 37 37 37 37 37 37 37 37 37 37 37 37 37 87 13 37 87 12 13 177 227 228 102 102 102 102 139 140 141 102 102 102 210 134 134 135 76 76 76 76 76 158 102 102 
37 37 37 37 37 37 55 105 31 31 31 31 31 31 31 31 31 31 31 31 31 31 31 31 31 31 31 31 31 31 31 31 31 31 31 31 31 31 31 31 31 31 31 31 31 31 31 31 31 31 31 106 56 56 56 105 31 31 31 31 31 31 31 31 31 31 31 31 31 31 31 31 31 31 31 31 31 31 31 31 31 31 31 31 31 31 31 31 31 31 31 31 31 31 31 31 31 31 31 31 31 31 31 31 31 31 31 31 106 57 37 37 37 37 37 37 37 37 243 317 318 26 26 26 14 90 26 26 91 15 16 26 26 26 26 291 37 37 37 37 37 37 37 37 37 37 37 37 37 37 37 37 37 37 37 37 37 37 37 37 37 37 37 37 37 37 202 278 283 164 165 166 283 283 283 276 201 37 37 37 37 37 37 37 37 37 37 37 37 37 37 37 37 37 37 37 30 31 31 31 31 32 37 37 37 37 37 37 37 37 37 37 37 37 37 37 37 37 37 37 87 13 37 37 87 13 37 177 228 102 102 102 164 165 166 102 102 102 102 102 102 210 134 134 134 134 134 209 102 102 
37 37 37 37 37 37 37 30 31 31 31 31 31 31 31 31 31 31 31 31 31 31 31 31 31 31 31 31 31 31 31 31 31 31 31 31 31 31 31 31 31 31 31 31 31 31 31 31 106 56 56 57 37 37 37 55 105 31 31 31 31 31 31 31 31 31 31 31 31 31 31 31 31 31 31 31 31 31 31 31 31 31 31 31 31 31 31 31 31 31 31 31 31 31 31 31 31 31 31 31 31 31 31 31 31 31 31 106 57 37 37 37 37 37 37 37 37 37 293 26 26 26 14 15 90 26 26 26 26 26 91 16 26 26 26 291 37 37 37 37 37 37 37 37 37 37 37 37 37 37 37 37 37 37 37 37 37 37 37 37 37 37 37 37 37 202 278 283 283 189 190 191 283 139 140 141 276 277 201 37 37 37 37 37 37 37 37 37 37 37 37 37 37 37 37 37 30 31 31 31 31 32 37 37 37 37 37 37 37 37 37 37 37 37 37 37 37 37 37 37 37 87 13 37 37 87 13 37 177 228 102 102 189 190 191 102 102 322 102 139 140 141 102 102 102 102 102 102 102 102 
37 37 37 37 37 37 37 55 56 105 31 31 31 31 31 31 31 31 31 31 31 31 31 31 31 31 31 31 31 31 31 31 31 31 31 31 31 31 31 31 31 31 31 31 31 31 31 106 57 37 37 37 37 37 37 37 55 105 31 31 31 31 31 31 31 31 31 31 31 31 31 31 31 31 31 31 31 31 31 31 31 31 31 31 31 31 31 31 31 31 31 31 31 31 31 31 31 31 31 31 31 31 31 31 31 106 56 57 37 37 37 37 37 37 37 37 37 37 293 26 26 26 39 26 26 26 26 26 26 26 26 41 26 26 26 291 37 37 37 37 37 37 37 37 37 37 37 37 37 37 37 37 37 37 37 37 37 37 37 37 37 37 37 37 202 278 283 283 139 140 141 283 283 164 165 166 283 283 276 201 37 37 37 37 37 37 37 37 37 37 37 37 37 37 37 37 55 105 31 31 31 32 37 37 37 37 37 37 37 37 37 37 37 37 37 37 37 37 37 37 37 37 87 13 37 37 38 37 37 253 102 102 102 102 102 102 102 102 102 164 165 166 102 322 102 102 335 102 102 335 
37 37 37 37 37 37 37 37 37 55 56 56 56 56 56 56 56 105 31 31 31 31 31 31 31 31 31 31 31 31 31 31 31 31 31 31 31 31 31 31 31 31 31 31 31 31 106 57 37 37 37 37 37 37 37 37 37 55 56 105 31 31 31 31 31 31 31 31 31 31 31 31 31 31 31 31 31 31 31 31 31 31 31 31 31 31 31 31 31 31 31 31 31 31 31 31 31 31 31 31 31 31 31 31 106 57 37 37 37 37 37 37 37 37 37 37 37 37 293 26 26 26 39 26 26 26 26 26 26 26 116 66 26 26 26 291 37 37 37 37 37 37 37 37 37 37 37 37 37 37 37 37 37 37 37 37 37 37 37 37 37 37 37 37 253 139 140 141 164 165 166 283 283 189 190 191 283 283 283 276 277 201 37 37 37 37 37 37 37 37 37 37 37 37 37 37 37 30 31 31 31 32 37 37 37 37 37 37 37 37 37 37 37 37 37 37 37 37 37 37 37 37 37 87 13 37 87 13 37 177 228 102 102 322 102 102 102 102 102 189 190 191 102 102 102 102 102 102 102 102 
37 37 37 37 37 37 37 37 37 37 37 37 37 37 37 37 37 55 56 56 105 31 31 31 31 31 31 31 31 31 31 31 31 31 31 31 31 31 31 31 31 31 31 31 106 56 57 37 37 37 37 37 37 37 37 37 37 37 37 55 105 31 31 31 31 31 31 31 31 31 31 31 31 31 31 31 31 31 31 31 31 31 31 31 31 31 31 31 31 31 31 31 31 31 31 31 31 31 31 31 31 31 106 56 57 37 37 37 37 37 37 37 37 37 37 37 37 37 218 268 26 26 64 65 65 65 65 65 65 65 66 26 26 26 26 291 37 37 37 37 37 37 37 37 37 37 37 37 37 37 37 37 37 37 37 37 37 37 37 37 37 37 37 202 278 164 165 166 189 190 191 283 283 283 283 283 283 139 140 141 283 276 201 37 37 37 37 37 37 37 37 37 37 37 37 37 37 55 56 56 56 57 37 37 37 37 37 37 37 37 37 37 37 37 37 37 37 37 37 37 37 37 37 37 87 13 37 38 37 37 253 102 102 102 102 102 102 320 102 102 102 102 102 102 102 102 322 102 336 102 
37 37 37 37 37 37 37 37 37 37 37 37 37 37 37 37 37 37 37 37 30 31 31 31 31 31 31 31 31 31 31 31 31 31 31 31 31 31 31 31 31 31 106 56 57 37 37 37 37 37 37 37 37 37 37 37 37 37 37 37 55 56 31 31 31 31 31 31 31 31 31 31 31 31 31 31 31 31 31 31 31 31 31 31 31 31 31 31 31 31 31 31 31 31 31 31 31 31 31 31 106 56 57 37 37 37 37 37 37 37 37 37 37 37 37 37 37 37 37 218 267 267 268 26 26 26 26 26 26 26 26 26 266 267 267 217 37 37 37 37 37 37 37 37 37 37 37 37 37 37 37 37 37 37 37 37 37 37 37 37 37 37 37 253 283 189 190 191 283 283 283 139 140 141 283 283 283 164 165 166 283 283 251 37 37 37 37 37 37 37 37 37 37 37 37 37 37 37 37 37 37 37 37 37 37 37 37 37 37 37 37 37 37 37 37 37 37 37 37 37 37 37 37 37 37 87 13 87 13 37 177 228 102 102 102 102 102 102 102 102 102 102 102 102 102 102 102 102 102 102
