20x20.bmp 250:24
28 28 28 28 28 28 28 28 28 28 29 31 31 31 31 31 31 31 31 31 31 31 31 31 31 31 32 37 37 37 37 37 37 37 37 37 37 37 37 37 37 37 37 253 283 283 320 283 283 307 308 308 232 283 321 283 189 190 191 189 190 191 189 190 191 283 283 189 190 191 207 308 308 308 308 309 283 283 322 251 37 37 37 37 37 37 37 37 37 37 37 37 37 37 37 37 37 37 37 37 37 114 187 187 187 187 113 37 37 37 37 37 37 37 37 37 37 37 37 37 163 289 390 362 363 363 363 363 363 363 363 363 363 363 363 363 363 363 363 363 363 363 363 364 289 129 343 128 369 76 76 76 45 40 40 40 40 40 40 40 40 47 76 183 234 283 164 165 241 191 283 283 283 189 190 190 191 283 283 160 49 49 49 49 49 49 49 49 49 49 49 45 40 40 40 40 40 40 40 40 64 115 40 40 40 40 40 40 40 40 40 40 40 40 40 116 66 40 40 40 40 40 47 49 49 49 49 158 189 240 165 166 283 257 233 283 189 190 191 283 283 282 283 189 240 165 241 191 164 165 
28 28 28 28 28 28 28 28 28 28 79 4 31 31 31 31 31 31 31 31 31 31 31 31 31 31 81 6 7 37 37 37 37 37 37 37 37 37 37 37 37 37 37 177 227 228 283 283 283 322 283 283 307 308 308 308 232 283 283 283 283 283 283 283 283 207 308 308 308 308 309 283 283 320 283 321 283 283 226 176 37 37 37 37 37 37 37 37 37 37 37 37 37 37 37 37 37 37 37 114 187 188 289 289 289 289 186 187 113 37 37 37 37 37 37 37 37 37 37 37 163 289 289 362 363 363 363 363 363 363 363 363 363 363 363 363 363 363 363 363 363 363 363 341 339 289 289 289 129 344 76 76 70 121 40 40 40 40 40 40 122 72 76 76 183 234 189 190 191 283 283 139 140 141 283 283 321 283 283 210 135 49 49 49 49 49 49 49 49 49 49 70 121 40 40 40 40 40 40 40 40 64 65 115 40 40 40 40 116 65 65 65 65 65 65 66 40 40 40 40 40 122 72 49 49 49 133 209 283 189 190 191 257 233 283 283 283 283 283 283 283 282 283 283 189 190 191 283 164 165 
28 28 28 28 28 28 28 28 28 28 28 79 4 31 31 31 31 31 31 31 31 31 31 31 31 31 31 31 81 6 7 37 37 37 37 37 37 37 37 37 37 37 37 37 37 177 227 227 227 228 283 283 283 283 283 283 307 308 308 308 308 308 308 308 308 309 283 283 322 283 283 283 283 283 283 283 226 227 176 37 37 37 37 37 37 37 37 37 37 37 37 37 37 37 37 37 37 37 114 188 289 289 289 289 289 289 289 289 186 113 37 37 37 37 37 37 37 37 37 114 188 289 289 362 363 363 363 363 363 363 363 363 363 363 363 363 363 363 363 363 363 363 363 363 364 289 390 289 289 369 76 76 76 70 121 40 40 40 40 122 72 76 76 76 76 183 234 283 283 283 283 164 165 166 283 283 283 283 283 283 210 135 49 49 49 49 49 49 49 49 49 49 70 71 71 121 40 40 40 40 40 40 40 64 65 65 65 65 66 40 40 40 40 40 40 40 40 40 40 122 71 72 49 49 49 133 209 283 283 283 283 257 233 283 139 141 283 283 283 283 257 233 283 283 283 320 283 139 215 165 
28 28 28 28 28 28 28 28 28 28 28 28 79 4 31 31 31 31 31 31 31 31 31 31 31 31 31 31 31 31 81 6 7 37 37 37 37 37 37 37 37 37 37 37 37 37 37 37 37 177 228 283 283 320 283 322 283 283 283 283 283 283 322 283 283 283 321 283 283 283 283 226 227 227 227 227 176 37 37 37 37 37 37 37 37 37 37 37 37 37 37 37 37 37 37 37 114 187 188 289 289 289 289 289 289 289 289 289 289 161 37 37 37 37 37 37 37 37 114 188 289 289 396 362 363 363 363 363 363 363 363 363 363 363 363 363 363 363 363 363 363 363 363 363 341 339 289 289 289 369 76 76 76 76 70 71 71 71 71 72 76 76 76 76 76 76 183 234 283 283 283 189 190 191 283 283 283 283 283 283 283 210 134 134 134 135 49 49 49 49 49 49 49 49 49 70 71 71 71 71 121 40 40 40 40 40 40 40 40 40 40 40 122 71 71 71 71 71 71 72 49 49 49 49 49 158 283 283 283 283 257 233 283 139 215 216 141 283 283 257 233 283 283 283 283 283 283 164 165 165 
28 28 28 28 28 28 28 28 28 28 28 28 28 29 31 31 31 31 31 31 31 31 31 31 31 31 31 31 31 31 31 31 81 6 7 37 37 37 37 37 37 37 37 37 37 37 37 37 37 37 177 227 227 227 227 228 283 283 283 283 320 283 283 283 226 227 227 227 227 227 227 176 37 37 37 37 37 37 37 37 37 37 37 37 37 37 37 37 37 37 37 37 37 37 37 114 188 289 289 289 289 154 393 153 289 289 396 289 289 186 113 37 37 37 37 37 37 114 188 289 289 289 289 387 365 363 363 363 363 363 363 363 363 363 363 363 363 363 363 363 363 363 363 363 363 364 289 154 153 129 344 76 76 76 76 76 76 76 76 76 76 76 76 76 76 76 76 158 283 322 283 283 283 283 283 139 140 140 141 283 283 283 283 320 283 210 134 135 49 49 49 49 49 49 49 49 49 49 49 49 70 71 71 71 71 71 71 71 71 71 71 71 72 49 49 49 49 49 49 49 49 49 49 49 133 209 283 283 283 257 233 283 283 189 240 241 191 283 257 233 283 283 283 283 283 283 283 164 165 165 
28 28 28 28 28 28 28 28 28 28 28 28 28 79 4 31 31 31 31 31 31 31 31 31 31 31 31 31 31 31 31 31 31 31 81 6 6 7 37 37 37 37 37 37 37 37 37 37 37 37 37 37 37 37 37 177 227 227 227 227 227 227 227 227 176 37 37 37 37 37 37 37 37 37 37 37 37 37 37 37 37 37 37 37 37 37 37 37 37 37 37 37 37 37 114 188 289 391 289 289 289 369 76 367 289 289 289 289 289 289 186 113 37 37 37 37 114 188 289 289 289 289 289 289 362 363 363 363 363 363 363 363 363 363 363 363 363 363 363 363 363 363 363 363 363 341 339 129 128 289 369 76 76 76 76 76 76 76 76 76 76 76 76 76 76 76 76 183 234 283 283 283 283 283 139 215 165 165 216 140 140 140 140 140 140 141 283 210 134 135 49 49 49 49 49 49 49 49 49 49 49 49 49 49 49 49 49 49 49 49 49 49 49 49 49 49 49 49 49 49 49 49 49 133 209 283 283 283 257 233 283 283 283 283 189 191 283 283 282 283 283 320 283 283 322 283 283 164 165 165 
28 28 28 28 28 28 28 28 28 28 28 28 28 28 79 4 31 31 31 31 31 31 31 31 31 31 31 31 31 31 31 31 31 31 31 31 31 81 6 6 7 37 37 37 37 37 37 37 37 37 37 37 37 37 37 37 37 37 37 37 37 37 37 37 37 37 37 37 37 37 37 37 37 37 37 37 37 37 37 37 37 37 37 37 37 37 37 37 37 37 37 37 37 114 188 289 289 289 289 289 289 129 343 128 289 289 289 390 289 289 289 186 187 187 187 187 188 289 289 289 289 154 153 289 362 363 363 363 363 363 363 363 363 363 363 363 363 363 363 363 363 363 363 363 363 363 364 289 289 289 129 344 76 76 76 76 76 76 76 76 76 76 76 76 76 76 76 76 183 234 283 283 283 283 164 165 165 165 165 165 165 165 165 165 165 216 140 141 283 210 134 134 135 49 49 49 49 49 49 49 49 49 49 49 49 49 49 49 49 49 49 49 49 49 49 49 49 49 49 49 49 133 134 209 283 283 283 257 233 283 139 140 141 322 283 283 283 283 282 283 283 283 283 283 283 283 283 164 165 165 
28 28 28 28 28 28 28 28 28 28 28 28 28 28 28 29 31 31 31 31 31 31 31 31 31 31 31 31 31 31 31 31 31 31 31 31 31 31 31 31 81 7 37 37 37 37 37 37 37 37 37 37 37 37 37 37 37 37 37 37 37 37 37 37 37 37 37 37 37 37 37 37 37 37 37 37 37 37 37 37 37 37 37 37 37 37 37 37 37 37 37 114 187 188 289 289 289 289 289 289 391 289 289 289 289 289 289 289 289 289 390 289 289 289 289 289 289 289 391 289 289 129 128 289 387 365 363 363 363 363 363 363 363 363 363 363 363 363 363 363 363 363 363 363 363 363 364 289 395 289 289 129 344 76 76 76 76 76 76 76 76 76 76 76 76 76 76 76 76 158 283 283 283 283 164 165 165 165 165 165 165 165 165 165 165 165 165 216 140 141 322 283 210 134 134 134 134 134 135 49 49 49 49 49 49 49 49 49 49 49 49 49 49 49 49 49 49 49 49 133 134 209 283 283 283 257 258 233 283 139 215 165 216 141 283 283 283 257 233 283 283 283 139 140 141 283 283 164 165 165 
28 28 28 28 28 28 28 28 28 28 28 28 28 28 28 29 31 31 31 31 31 31 31 31 31 31 31 31 31 31 31 31 31 31 31 31 31 31 31 31 31 81 6 7 37 37 37 37 37 37 37 37 37 37 37 37 37 37 37 37 37 37 37 37 37 37 37 37 37 37 37 37 37 37 37 37 37 37 37 37 37 37 37 37 37 37 37 37 37 37 114 188 289 289 289 396 289 289 395 289 289 289 289 396 289 337 338 338 339 289 289 289 289 289 289 289 289 289 289 289 289 289 289 289 289 362 363 363 363 363 363 363 363 363 363 363 363 363 363 363 363 363 363 363 363 363 364 289 289 289 289 289 129 344 76 76 76 76 76 76 76 20 21 21 21 22 76 76 76 183 234 283 283 139 215 165 165 165 165 165 165 165 165 165 165 165 165 165 165 216 140 141 283 283 283 283 283 283 210 134 134 134 134 134 134 134 134 134 134 134 134 134 134 134 134 134 134 134 134 209 283 283 283 283 257 233 283 283 139 215 165 165 165 216 141 283 283 282 283 283 283 283 164 165 166 283 283 164 165 165 
28 28 28 28 28 28 28 28 28 28 28 28 28 28 28 29 31 31 31 31 31 31 31 31 31 31 31 31 31 31 31 31 31 31 31 31 31 31 31 31 31 31 31 81 7 37 37 37 37 37 37 37 37 37 37 37 37 37 37 37 37 37 37 37 37 37 37 37 37 37 37 37 37 37 37 37 37 37 37 37 37 37 37 37 37 37 37 37 37 37 163 289 289 289 289 289 289 289 289 289 289 289 289 289 337 340 363 363 341 339 289 289 396 289 289 396 289 397 289 289 289 289 289 390 289 387 365 363 363 363 363 363 363 363 363 363 363 363 363 363 363 363 363 363 363 363 364 289 154 393 153 289 289 129 344 76 76 76 76 76 76 45 40 40 40 97 22 76 76 76 158 283 283 164 165 165 165 165 165 165 165 165 165 165 165 165 165 165 165 165 165 216 141 141 283 283 283 283 283 283 283 139 141 283 283 283 283 283 283 283 283 283 283 283 283 283 283 283 283 283 283 283 283 257 233 283 283 139 215 165 165 165 165 165 166 283 257 233 283 283 283 283 189 190 191 283 283 164 165 165 
28 28 28 28 28 28 28 28 28 28 28 28 28 28 28 29 31 31 31 31 31 31 31 31 31 31 31 31 31 31 31 31 31 31 31 31 31 31 31 31 31 31 31 31 81 6 7 37 37 37 37 37 37 37 37 37 37 37 37 37 37 37 37 37 37 37 37 37 37 37 37 37 37 37 37 37 37 37 37 37 37 37 37 37 37 37 37 37 37 114 188 390 289 289 289 289 289 289 289 337 338 338 338 338 340 363 363 363 363 341 338 339 289 289 289 289 289 289 289 154 393 153 289 289 289 289 362 363 363 363 363 363 363 363 363 363 363 363 363 363 363 363 363 363 363 363 364 289 369 76 367 289 289 289 369 76 76 76 76 76 76 45 40 40 40 40 97 22 76 76 183 234 283 164 165 165 165 165 165 165 165 165 165 165 165 165 165 165 165 165 165 165 165 216 141 283 283 283 283 283 139 215 216 141 283 283 283 283 142 143 143 143 143 143 143 143 144 283 283 320 283 283 257 233 283 283 139 215 165 165 165 165 165 241 191 283 282 283 283 283 283 283 320 283 283 283 139 215 165 165 
28 28 28 28 28 28 28 28 28 28 28 28 28 28 28 29 31 31 31 31 31 31 31 31 31 31 31 31 31 31 31 31 31 31 31 31 31 31 31 31 31 31 31 31 31 31 81 7 37 37 37 37 37 37 37 37 37 37 37 37 37 37 37 37 37 37 37 37 37 37 37 37 37 37 37 37 37 37 37 37 37 37 37 37 37 37 37 37 114 188 289 289 289 289 154 153 289 289 289 362 363 363 363 363 363 363 363 363 363 363 363 341 339 289 289 289 289 289 289 369 76 367 289 289 289 289 387 388 365 363 363 363 363 363 363 363 363 363 363 363 363 363 363 363 363 366 389 289 129 343 128 289 396 289 129 344 76 76 76 76 76 45 40 40 40 40 40 47 76 76 76 158 283 164 165 165 165 165 165 165 165 165 165 165 165 165 165 165 165 165 165 165 165 165 216 141 283 283 320 283 189 240 241 191 283 322 283 142 94 168 168 168 168 168 168 168 169 283 283 283 283 283 282 283 283 283 164 165 165 165 165 165 241 191 283 257 233 283 283 139 141 283 283 283 283 283 164 165 165 165 
28 28 28 28 28 28 28 28 28 28 28 28 28 28 28 29 31 31 31 31 31 31 31 31 31 31 31 31 31 31 31 31 31 31 31 31 31 31 31 31 31 31 31 31 31 31 31 81 7 37 37 37 37 37 37 37 37 37 37 37 37 37 37 37 37 37 37 37 37 37 37 37 37 37 37 37 37 37 37 37 37 37 37 37 37 37 37 114 188 289 289 289 289 289 129 128 289 289 337 340 363 363 363 363 363 363 363 363 363 363 363 363 364 289 397 289 289 289 289 129 343 128 289 289 289 395 289 289 387 365 363 363 363 363 363 363 363 363 363 363 363 363 363 363 363 364 289 289 289 289 289 289 289 289 289 129 344 76 76 76 76 70 121 40 40 40 40 97 22 76 76 158 283 164 165 165 165 165 165 165 165 165 165 165 165 165 165 165 165 165 165 165 165 165 165 216 140 141 283 283 283 189 191 283 283 283 142 94 168 168 295 168 168 168 270 168 169 283 283 283 283 283 282 283 283 139 215 165 165 165 165 241 191 283 283 282 283 283 139 215 216 141 283 283 283 139 215 165 165 165 
28 28 28 28 28 28 28 28 28 28 28 28 28 28 28 29 31 31 31 31 31 31 31 31 31 31 31 31 31 31 31 31 31 31 31 31 31 31 31 31 31 31 31 31 31 31 31 31 81 7 37 37 37 37 37 37 37 37 37 37 37 37 37 37 37 37 37 37 37 37 37 37 37 37 37 37 37 37 37 37 37 37 37 37 37 37 114 188 289 289 289 396 289 289 289 289 390 289 362 363 363 363 363 363 363 363 363 363 363 363 363 363 364 289 289 395 289 289 289 289 289 289 396 289 289 289 289 289 289 387 365 363 363 363 363 363 363 363 363 363 363 363 363 363 363 364 289 289 289 263 264 264 265 289 289 289 129 344 76 76 76 76 45 40 40 40 40 40 47 76 76 158 283 164 165 165 165 165 165 165 165 165 165 165 165 165 165 165 165 165 165 165 165 165 165 165 165 216 141 283 283 283 283 283 283 283 167 168 168 347 168 168 295 168 168 168 95 144 283 283 283 257 233 283 283 164 165 165 165 165 165 166 283 283 257 233 283 283 189 240 241 191 283 283 139 215 165 165 165 165 
28 28 28 28 28 28 28 28 28 28 28 28 28 28 28 29 31 31 31 31 31 31 31 31 31 31 31 31 31 31 31 31 31 31 31 31 31 31 31 31 31 31 31 31 31 31 31 31 31 81 7 37 37 37 37 37 37 37 37 37 37 37 37 37 37 37 37 37 37 37 37 37 37 37 37 37 37 37 37 37 37 37 37 37 114 187 188 289 289 289 289 289 289 289 289 289 289 337 340 363 363 363 363 363 363 363 363 363 363 363 363 363 341 339 289 289 289 289 289 289 289 289 289 289 289 289 289 289 289 289 387 365 363 363 363 363 363 363 363 363 363 363 363 363 366 389 289 289 263 213 289 289 290 289 289 289 289 369 76 76 76 76 70 121 40 40 40 40 47 76 76 158 283 189 240 165 165 165 165 165 165 165 165 165 165 165 165 165 165 165 165 165 165 165 165 165 165 165 166 283 283 283 283 283 321 283 167 168 168 168 168 270 168 345 168 295 168 169 283 283 283 282 283 283 139 215 165 165 165 165 241 191 283 257 233 283 283 283 283 189 191 283 139 140 215 165 165 165 165 165 
28 28 28 28 28 28 28 28 28 28 28 28 28 28 28 29 31 31 31 31 31 31 31 31 31 31 31 31 31 31 31 31 31 31 31 31 31 31 31 31 31 31 31 31 31 31 31 31 31 31 81 6 7 37 37 37 37 37 37 37 37 37 37 37 37 37 37 37 37 37 37 37 37 37 37 37 37 37 37 37 37 114 187 187 188 289 289 289 391 289 289 395 289 289 289 289 337 340 363 363 363 363 363 363 363 363 363 363 363 363 363 363 363 364 289 289 289 289 289 289 289 289 289 289 289 289 289 289 289 289 289 387 365 363 363 363 363 363 363 363 363 363 363 363 364 289 289 289 288 289 391 289 290 289 154 153 289 369 49 49 76 76 76 70 121 40 40 40 47 76 76 158 283 283 189 240 165 165 165 165 165 165 165 165 165 165 165 165 165 165 165 165 165 165 165 165 165 165 166 283 283 283 283 283 283 283 167 168 168 295 168 168 168 295 168 168 168 169 283 283 283 282 283 283 164 165 165 165 165 165 166 283 257 233 283 283 283 283 283 283 283 139 215 165 165 165 165 165 165 165 
28 28 28 28 28 28 28 28 28 28 28 28 28 28 28 29 31 31 31 31 31 31 31 31 31 31 31 31 31 31 31 31 31 31 31 31 31 31 31 31 31 31 31 31 31 31 31 31 31 31 31 31 81 7 37 37 37 37 37 37 37 37 37 37 37 37 37 37 37 37 37 37 37 37 37 37 37 37 37 114 187 188 289 289 289 289 289 289 289 289 289 289 289 289 289 337 340 363 363 363 363 363 363 363 363 363 363 363 363 363 363 363 363 364 289 289 391 289 289 154 153 289 289 289 154 393 153 289 397 289 289 289 387 388 365 363 363 363 363 363 363 363 363 366 389 289 397 289 288 289 154 153 290 289 129 128 289 369 76 76 76 76 76 76 45 40 40 40 47 76 76 158 283 321 283 189 240 165 165 165 165 165 165 165 165 165 165 165 165 165 165 165 165 165 165 165 165 241 191 283 320 283 283 283 283 283 192 119 168 168 168 168 168 168 168 168 120 194 283 322 283 282 283 283 189 240 165 165 165 241 191 283 282 283 283 283 283 283 283 283 139 215 165 165 165 165 165 165 165 165 
28 28 28 28 28 28 28 28 28 28 28 28 28 28 28 29 31 31 31 31 31 31 31 31 31 31 31 31 31 31 31 31 31 31 31 31 31 31 31 31 31 31 31 31 31 31 31 31 31 31 31 31 31 32 37 37 37 37 37 37 37 37 37 37 37 37 37 37 37 37 37 37 37 37 37 37 37 37 114 188 289 289 289 289 289 289 154 393 153 289 289 289 289 391 337 340 363 363 363 363 363 363 363 363 363 363 363 363 363 363 363 363 363 341 339 289 289 289 289 129 128 289 289 289 369 76 367 289 289 289 391 289 289 289 387 365 363 363 363 363 363 366 388 389 289 289 289 289 288 289 129 128 290 289 289 289 289 369 76 76 76 76 76 76 45 40 40 122 72 76 76 158 283 283 283 283 189 190 190 190 190 190 240 165 165 165 241 190 190 190 240 165 165 241 190 190 190 191 283 283 283 283 139 140 141 283 283 192 193 193 193 193 193 193 193 193 194 283 283 283 283 282 283 283 283 164 165 165 241 191 283 283 282 283 283 321 283 283 283 139 215 165 165 165 165 165 165 165 165 165 
28 28 28 28 28 28 28 28 28 28 28 28 28 28 104 54 31 31 31 31 31 31 31 31 31 31 31 31 31 31 31 31 31 31 31 31 31 31 31 31 31 31 31 31 31 31 31 31 31 31 31 31 31 81 7 37 37 37 37 37 37 37 37 37 37 37 37 37 37 37 37 37 37 37 37 37 37 114 188 289 289 391 289 289 289 289 369 76 367 289 289 289 289 337 340 363 363 363 363 363 363 363 363 363 363 363 363 363 363 363 363 363 363 363 341 339 289 289 289 289 289 289 289 289 129 343 128 289 289 289 289 289 289 289 289 387 388 388 388 388 388 389 289 289 289 289 390 289 313 238 289 239 315 289 289 390 289 369 76 76 76 76 76 76 70 71 71 72 76 76 76 158 283 283 283 283 283 283 283 283 283 283 189 190 190 190 191 320 283 283 189 190 190 191 283 283 322 283 283 283 283 283 164 165 166 283 283 283 283 283 283 283 283 283 283 283 283 283 283 283 283 307 232 283 283 189 240 165 166 283 283 257 233 283 283 283 283 283 139 215 165 165 165 165 165 165 165 165 165 165 
28 28 28 28 28 28 28 28 28 28 28 28 28 28 29 31 31 31 31 31 31 31 31 31 31 31 31 31 31 31 31 31 31 31 31 31 31 31 31 31 31 31 31 31 31 31 31 31 31 31 31 31 31 31 32 37 37 37 37 37 37 37 37 37 37 37 37 37 37 37 37 37 37 37 37 37 114 188 289 289 289 289 289 390 289 289 129 343 128 289 289 289 337 340 363 363 363 363 363 363 363 363 363 363 363 363 363 363 363 363 363 363 363 363 363 341 339 289 289 289 289 289 289 289 289 289 289 289 289 289 289 395 289 289 289 289 289 289 289 289 289 289 289 289 289 289 289 289 289 313 314 315 289 289 397 289 154 394 76 76 76 76 76 76 76 76 76 76 76 76 76 158 283 283 283 283 321 283 283 283 283 235 184 184 184 184 184 184 184 184 184 184 184 184 184 184 184 184 234 283 283 283 189 190 191 283 283 283 283 283 283 283 283 283 283 283 283 283 283 283 283 283 282 283 283 283 189 283 191 283 283 282 283 283 283 283 283 283 164 165 165 165 165 165 165 165 165 165 165 165 
28 28 28 28 28 28 28 28 28 28 28 28 28 104 54 31 31 31 31 31 31 31 31 31 31 31 31 31 31 31 31 31 31 31 31 31 31 31 31 31 31 31 31 31 31 31 31 31 31 31 31 31 31 31 81 7 37 37 37 37 37 37 37 37 37 37 37 37 37 37 37 37 37 37 37 114 188 289 289 154 393 153 289 289 289 289 289 289 289 289 289 289 362 363 363 363 363 363 363 363 363 363 363 363 363 363 363 363 363 363 363 363 363 363 363 363 341 339 289 289 289 289 391 289 289 289 397 289 289 289 289 289 289 263 264 264 264 264 264 264 264 264 265 289 289 289 395 289 289 289 289 289 289 289 289 289 369 76 76 76 76 76 76 76 76 76 76 76 76 76 76 158 283 283 322 283 283 283 283 235 184 185 49 49 49 49 49 49 49 49 49 49 49 49 49 49 49 49 183 184 184 184 184 184 234 283 283 283 283 283 320 283 283 139 140 141 283 283 283 283 283 283 282 283 283 283 283 283 283 283 283 282 283 283 283 283 283 283 164 165 165 165 165 165 165 165 165 165 165 165 
28 28 28 28 28 28 28 28 28 28 28 28 28 29 31 31 31 31 31 31 31 31 31 31 31 2 3 3 3 3 3 3 3 3 3 4 31 31 31 31 31 31 31 31 31 31 31 31 31 31 31 31 31 31 31 32 37 37 37 37 37 37 37 37 37 37 37 37 37 37 37 37 37 37 37 163 289 289 289 369 76 367 289 289 395 289 289 289 391 289 289 289 362 363 363 363 363 363 363 363 363 363 363 363 363 363 363 363 363 363 363 363 363 363 363 363 363 341 338 338 339 289 289 289 289 289 289 289 289 289 263 264 264 213 289 289 289 289 289 289 289 289 214 264 265 289 289 289 289 289 289 289 154 153 289 154 394 76 76 76 21 21 21 21 21 22 76 76 76 76 76 158 283 283 283 283 283 235 184 185 49 49 49 49 49 49 49 49 49 49 49 49 49 49 49 49 49 49 49 49 49 49 49 49 183 184 184 184 234 283 283 283 283 164 165 166 283 283 283 283 283 283 282 283 283 283 283 283 283 321 283 282 283 283 283 283 283 139 215 165 165 165 165 165 165 165 165 165 165 165 
28 28 28 28 28 28 28 28 28 28 28 28 104 54 31 31 31 31 31 31 31 31 31 2 3 78 28 28 28 28 28 28 28 28 28 79 3 3 4 31 31 31 31 31 31 31 31 31 31 31 31 31 31 31 31 81 7 37 37 37 37 37 37 37 37 37 37 37 37 37 37 37 37 37 37 163 289 289 289 129 343 128 289 289 289 289 289 289 289 289 289 337 340 363 363 363 363 363 363 363 363 363 363 363 363 363 363 363 363 363 363 363 363 363 363 363 363 363 363 363 364 289 397 289 289 289 391 289 263 264 213 289 154 393 153 289 289 289 289 289 391 289 289 289 214 264 264 265 289 391 289 289 129 128 289 369 76 76 76 45 40 40 40 40 40 97 22 76 76 76 76 158 283 283 283 235 184 185 49 49 49 49 49 49 49 20 21 21 21 21 21 21 21 21 21 21 22 49 49 49 49 49 49 49 49 49 49 49 183 184 234 283 283 189 190 191 283 283 139 140 141 283 282 283 322 283 283 283 283 283 283 282 283 283 283 283 139 215 165 165 165 165 165 165 165 165 165 165 165 165 
28 28 28 28 28 28 28 28 28 28 28 104 54 31 31 31 31 31 31 31 2 3 3 78 28 28 28 28 28 28 28 28 28 28 28 28 28 28 79 3 3 4 31 31 31 31 31 31 31 31 31 31 31 31 31 31 32 37 37 37 37 37 37 37 37 37 37 37 37 37 37 37 37 37 37 163 289 289 289 289 289 289 154 393 153 391 289 289 289 289 289 362 363 363 363 363 363 363 363 363 363 363 363 363 363 363 363 363 363 363 363 363 363 363 363 363 363 363 363 363 364 289 289 154 153 289 289 289 288 289 289 289 369 76 367 289 289 154 393 153 289 289 289 289 154 153 289 290 289 289 289 289 289 289 289 369 76 76 76 45 40 40 40 40 40 40 47 76 76 76 76 158 139 140 141 160 49 49 49 49 49 49 49 49 49 45 40 14 15 15 15 16 40 40 40 40 47 49 49 49 49 49 49 49 49 49 49 49 49 49 158 283 283 283 283 283 283 139 215 165 166 283 282 283 283 283 139 140 141 283 283 282 283 283 283 283 164 165 165 165 165 165 165 165 165 165 165 165 165 165
