20x20.bmp 80:80
165 165 165 165 165 165 165 165 165 165 165 165 165 165 165 165 165 165 165 165 165 165 165 165 165 165 165 165 165 165 165 165 165 165 165 165 165 165 165 165 165 165 165 165 165 165 165 165 165 165 165 165 165 165 165 165 165 165 165 165 165 165 165 165 165 165 165 165 165 165 165 165 165 165 165 165 165 165 165 165 
165 165 165 165 165 165 165 165 165 165 165 165 165 165 165 165 165 165 165 165 165 165 165 165 165 165 165 165 165 165 165 165 165 165 165 165 165 165 165 165 165 165 165 165 165 165 165 165 165 165 165 165 165 165 165 165 165 165 165 165 165 165 165 165 165 165 165 165 165 165 165 165 165 165 165 165 165 165 165 165 
165 165 165 165 165 165 165 165 165 165 165 165 165 165 165 165 165 165 165 165 165 165 165 165 165 165 165 165 165 165 165 165 165 165 165 165 165 165 165 165 165 165 165 165 165 165 165 165 165 165 165 165 165 165 165 165 165 165 165 165 165 165 165 165 165 165 165 165 165 165 165 165 165 165 165 165 165 165 165 165 
165 165 165 165 165 165 165 165 165 165 165 165 165 165 165 165 165 165 165 165 165 165 165 165 165 165 165 165 165 165 165 165 165 165 165 165 165 165 165 165 165 165 165 165 165 165 165 165 165 165 165 165 165 165 165 165 165 165 165 165 165 165 165 165 165 165 165 165 165 165 165 165 165 165 165 165 165 165 165 165 
165 165 165 165 165 165 165 165 165 165 165 165 165 165 165 165 165 165 165 165 165 165 165 165 165 165 165 165 165 165 165 165 165 165 165 165 165 165 165 165 165 165 165 165 165 165 165 165 165 165 165 165 165 165 165 165 165 165 165 165 165 165 165 165 165 165 165 165 165 165 165 165 165 165 165 165 165 165 165 165 
165 165 165 165 165 165 165 165 165 165 165 165 165 165 165 165 165 165 165 165 165 165 165 165 165 165 165 165 165 165 165 165 165 165 165 165 165 165 165 165 165 165 165 165 165 165 165 165 165 165 165 165 165 165 165 165 165 165 165 165 165 165 165 165 165 165 165 165 165 165 165 165 165 165 165 165 165 165 165 165 
165 165 165 165 165 165 165 165 165 165 165 165 165 165 165 165 165 165 165 165 165 165 165 165 165 165 165 165 165 165 165 165 165 165 165 165 165 165 165 165 165 165 165 165 165 165 165 165 165 165 165 165 165 165 165 165 165 165 165 165 165 165 165 165 165 165 165 165 165 165 165 165 165 165 165 165 165 165 165 165 
165 165 165 165 165 165 165 165 165 165 165 165 165 165 165 165 165 165 165 165 165 165 165 165 165 165 165 165 165 165 165 165 165 165 165 165 165 165 165 165 165 165 165 165 165 165 165 165 165 165 165 165 165 165 165 165 165 165 165 165 165 165 165 165 165 165 165 165 165 165 165 165 165 165 165 165 165 165 165 165 
165 165 165 165 165 165 165 165 165 165 165 165 165 165 165 165 165 165 165 165 165 165 165 165 165 165 165 165 165 165 165 165 165 165 165 165 165 165 165 165 165 165 165 165 165 165 165 165 165 165 165 165 165 165 165 165 165 165 165 165 165 165 165 165 165 165 165 165 165 165 165 165 165 165 165 165 165 165 165 165 
165 165 165 165 165 165 165 165 165 165 165 165 165 165 165 165 165 165 165 165 165 165 165 165 165 165 165 165 165 165 165 165 165 165 165 165 165 165 165 165 165 165 165 165 165 165 165 165 165 165 165 165 165 165 165 165 165 165 165 165 165 165 165 165 165 165 165 165 165 165 165 165 165 165 165 165 165 165 165 165 
165 165 165 165 165 165 165 165 165 165 165 165 165 165 165 165 165 165 165 165 165 165 165 165 165 165 165 165 165 165 165 165 165 165 165 165 165 165 165 165 165 165 165 165 165 165 165 165 165 165 165 165 165 165 165 165 165 165 165 165 165 165 165 165 165 165 165 165 165 165 165 165 165 165 165 165 165 165 165 165 
165 165 165 165 165 165 165 165 165 165 165 165 165 165 165 165 165 165 165 165 165 165 165 165 165 165 165 165 165 165 165 165 165 165 165 165 165 165 165 165 165 165 165 165 165 165 165 165 165 165 165 165 165 165 165 165 165 165 165 165 165 165 165 165 165 165 165 165 165 165 165 165 165 165 165 165 165 165 165 165 
165 165 165 165 165 165 165 165 165 165 165 165 165 165 165 165 165 165 165 165 165 165 165 165 165 165 165 165 165 165 165 165 165 165 165 165 165 165 165 165 165 165 165 165 165 165 165 165 165 165 165 165 165 165 165 165 165 165 165 165 165 165 165 165 165 165 165 165 165 165 165 165 165 165 165 165 165 165 165 165 
165 165 165 165 165 165 165 165 165 165 165 165 165 165 165 165 165 165 165 165 165 165 165 165 165 165 165 165 165 165 165 165 165 165 165 165 165 165 165 165 165 165 165 165 165 165 165 165 165 165 165 165 165 165 165 165 165 165 165 165 165 165 165 165 165 165 165 165 165 165 165 165 165 165 165 165 165 165 165 165 
165 165 165 165 165 165 165 165 165 165 165 165 165 165 165 165 165 165 165 165 165 165 165 165 165 165 165 165 165 165 165 165 165 165 241 190 190 190 190 190 190 190 240 165 165 165 165 165 165 165 165 165 165 165 165 165 165 165 165 165 165 165 165 165 165 165 165 165 165 165 165 165 165 165 165 165 165 165 165 165 
165 165 165 165 165 165 165 165 165 165 165 165 165 165 165 165 165 165 165 165 165 165 165 165 165 165 165 165 165 165 165 165 165 241 191 102 102 102 102 102 102 102 189 190 240 165 165 165 165 165 165 165 165 165 165 165 165 165 165 165 165 165 165 165 165 165 165 165 165 165 165 165 165 165 165 165 165 165 165 165 
165 165 165 165 165 165 165 165 165 165 165 165 165 165 165 165 165 165 165 165 165 165 165 165 165 165 165 165 165 165 165 165 165 166 102 102 102 102 102 102 102 102 102 102 189 240 165 165 165 165 165 165 165 165 165 165 165 165 165 165 165 165 165 165 165 165 165 165 165 165 165 165 165 165 165 165 165 165 165 165 
165 165 165 165 165 165 165 165 165 165 165 165 165 165 165 165 165 165 165 165 165 165 165 165 165 165 165 165 165 165 165 165 165 166 102 102 102 102 102 102 102 102 102 102 102 189 240 165 165 165 165 165 165 165 165 165 165 165 165 165 165 165 165 165 165 165 165 165 165 165 165 165 165 165 165 165 165 165 165 165 
165 165 165 165 165 165 165 165 165 165 165 165 165 165 165 165 165 165 165 165 165 165 165 165 165 165 165 165 165 165 165 165 241 191 102 102 102 102 102 102 102 102 102 102 102 102 189 190 240 165 165 165 165 165 165 165 165 165 241 190 240 165 165 165 165 165 165 165 165 165 165 165 165 165 165 165 165 165 165 165 
165 165 165 165 165 165 165 165 165 165 165 165 165 165 165 165 165 165 165 165 165 165 165 165 165 165 165 165 165 165 165 241 191 102 102 102 102 102 102 102 102 102 102 102 102 102 102 102 189 190 190 190 190 190 190 190 190 190 191 102 189 240 165 165 165 165 165 165 165 165 165 165 165 165 165 165 165 165 165 165 
165 165 165 165 165 165 165 165 165 165 165 165 165 165 165 165 165 165 165 165 165 165 165 165 165 165 165 165 165 165 241 191 102 102 102 102 102 102 102 102 102 102 102 102 102 102 102 102 102 102 102 102 102 102 102 102 102 102 102 102 102 189 240 165 165 165 165 165 165 165 165 165 165 165 165 165 165 165 165 165 
165 165 165 165 165 165 165 165 165 165 165 165 165 165 165 165 165 165 165 165 165 165 165 165 165 165 165 165 165 241 191 102 102 102 102 102 102 330 331 331 331 331 331 331 331 331 331 331 331 331 331 331 331 331 332 102 102 102 102 102 102 102 189 240 165 165 165 165 165 165 165 165 165 165 165 165 165 165 165 165 
165 165 165 165 165 165 165 165 165 165 165 165 165 165 165 165 165 165 165 165 165 165 165 165 165 165 165 165 241 191 102 102 102 102 102 102 102 355 327 328 327 328 327 328 327 328 327 328 327 328 327 328 327 328 357 102 102 102 102 102 102 102 102 189 240 165 165 165 165 165 165 165 165 165 165 165 165 165 165 165 
165 165 165 165 165 165 165 165 165 165 165 165 165 165 165 165 165 165 165 165 165 165 165 165 165 165 165 165 166 102 102 102 102 102 102 102 102 355 352 353 352 353 352 353 352 353 352 353 352 353 352 353 352 353 357 102 102 102 102 102 102 102 102 102 189 240 165 165 165 165 165 165 165 165 165 165 165 165 165 165 
165 165 165 165 165 165 165 165 165 165 241 190 190 190 190 190 240 165 165 165 165 165 165 165 165 165 165 165 166 102 102 102 102 102 102 102 102 355 327 328 327 328 327 328 327 328 327 328 327 328 327 328 327 328 357 102 102 102 102 102 102 102 102 102 102 164 165 165 165 165 165 165 165 165 165 165 165 165 165 165 
165 165 165 165 165 165 165 165 241 190 191 102 102 102 102 102 189 240 165 165 165 165 165 165 165 165 165 165 216 141 102 102 102 102 102 102 102 355 352 353 352 353 352 353 352 353 352 353 352 353 352 353 352 353 306 331 331 331 331 331 332 102 102 102 102 189 240 165 165 165 165 165 165 165 165 165 165 165 165 165 
165 165 165 165 165 165 165 241 191 102 102 102 102 102 102 102 102 189 240 165 165 165 165 165 165 165 165 165 165 216 141 102 102 102 102 102 102 355 327 328 327 328 327 328 327 328 327 328 327 328 327 328 327 328 327 328 327 328 327 328 357 102 102 102 102 102 164 165 165 165 165 165 165 165 165 165 165 165 165 165 
165 165 165 165 165 165 165 166 102 102 102 102 102 102 102 102 102 102 164 165 165 165 165 165 165 165 165 165 165 165 216 141 102 102 102 102 102 355 352 353 352 353 352 353 352 353 352 353 352 353 352 353 352 353 352 353 352 353 352 353 357 102 102 102 102 102 189 240 165 165 165 165 165 165 165 165 165 165 165 165 
165 165 165 165 165 165 165 166 102 102 102 102 102 102 102 102 102 102 189 240 165 165 165 165 165 165 165 165 165 165 165 166 102 102 102 102 102 355 327 328 327 328 327 328 327 328 327 328 327 328 327 328 327 328 327 328 327 328 327 328 357 102 102 102 102 102 102 164 165 165 165 165 165 165 165 165 165 165 165 165 
165 165 165 165 165 165 241 191 102 102 102 102 102 102 102 102 102 102 102 164 165 165 165 165 165 165 165 165 165 165 165 216 141 102 102 102 102 355 352 353 352 353 352 353 352 353 352 353 352 353 352 353 352 353 352 353 352 353 352 353 357 102 102 102 102 102 102 164 165 165 165 165 165 165 165 165 165 165 165 165 
165 165 165 165 165 241 191 102 102 102 102 102 102 102 102 102 102 102 102 189 240 165 165 165 165 165 165 165 165 165 165 165 166 102 102 102 102 355 327 328 327 328 327 328 327 328 327 328 327 328 327 328 327 328 327 328 327 328 327 328 357 102 102 102 102 102 102 164 165 165 165 165 165 165 165 165 165 165 165 165 
165 165 165 165 165 166 102 102 102 102 330 331 331 331 331 331 331 332 102 102 164 165 165 165 165 165 165 165 165 165 165 165 166 102 102 102 102 355 352 353 352 353 352 353 352 353 352 353 352 353 352 353 352 353 352 353 352 353 352 353 357 102 102 102 102 102 139 215 165 165 165 165 165 165 165 165 165 165 165 165 
165 165 165 165 165 166 102 102 102 102 355 327 328 327 328 327 328 357 102 102 189 240 165 165 165 165 165 165 165 165 165 165 166 102 102 102 102 355 327 328 327 328 327 328 327 328 327 328 327 328 327 328 327 328 306 381 381 381 381 381 382 102 102 102 102 139 215 165 165 165 165 165 165 165 165 165 165 165 165 165 
165 165 165 165 165 166 102 102 102 102 355 352 353 352 353 352 353 357 102 102 102 189 190 240 165 165 165 165 165 165 165 241 191 102 102 102 102 355 352 353 352 353 352 353 352 353 352 353 352 353 352 353 352 353 357 102 102 102 102 102 102 102 102 102 139 215 165 165 165 165 165 165 165 165 165 165 165 165 165 165 
165 165 165 165 165 166 102 102 102 102 355 327 328 327 328 327 328 357 102 102 102 102 102 189 240 165 165 165 165 165 241 191 102 102 102 102 102 355 327 328 327 328 327 328 327 328 327 328 327 328 327 328 327 328 357 102 102 102 102 102 102 102 102 139 215 165 165 165 165 165 165 165 165 165 165 165 165 165 165 165 
165 165 165 165 165 166 102 102 102 102 355 352 353 352 353 352 353 357 102 102 102 102 102 102 189 190 190 190 190 190 191 102 102 102 102 102 102 355 352 353 352 353 352 353 352 353 352 353 352 353 352 353 352 353 357 102 102 102 102 139 140 140 140 215 165 165 165 165 165 165 165 165 165 165 165 165 165 165 165 165 
165 165 165 165 165 216 141 102 102 102 355 327 328 327 328 327 328 357 102 102 102 102 102 102 102 102 102 102 102 102 102 102 102 102 102 102 102 355 327 328 327 328 327 328 327 328 327 328 327 328 327 328 327 328 357 102 102 102 139 215 165 165 165 165 165 165 165 165 165 165 165 165 165 165 165 165 165 165 165 165 
165 165 165 165 165 165 166 102 102 102 355 352 353 352 353 352 353 357 102 102 102 102 102 102 102 102 102 102 102 102 102 102 102 102 102 102 102 355 352 353 352 353 352 353 352 353 352 353 352 353 352 353 352 353 357 102 102 102 164 165 165 165 165 165 165 165 165 165 165 165 165 165 165 165 165 165 165 165 165 165 
165 165 165 165 165 165 166 102 102 102 355 327 328 327 328 327 328 357 102 102 102 102 102 102 102 102 102 102 102 102 102 102 102 102 102 102 102 355 327 328 327 328 327 328 327 328 327 328 327 328 327 328 327 328 357 102 102 102 164 165 165 165 165 165 165 165 165 165 165 165 165 165 165 165 165 165 165 165 165 165 
165 165 165 165 165 165 216 141 102 102 355 352 353 352 353 352 353 357 102 102 102 102 102 102 102 102 102 102 102 102 102 102 102 102 102 102 102 355 352 353 352 353 352 353 352 353 352 353 352 353 352 353 352 353 357 102 102 102 164 165 165 165 165 165 165 165 165 165 165 165 165 165 165 165 165 165 165 165 165 165 
165 165 165 165 165 165 165 166 102 102 355 327 328 327 328 327 328 357 102 102 359 301 329 301 329 301 329 301 329 301 329 301 329 301 329 358 102 355 327 328 327 328 327 328 327 328 327 328 327 328 327 328 327 328 357 102 102 102 164 165 165 165 165 165 165 165 165 165 165 165 165 165 165 165 165 165 165 165 165 165 
165 165 165 165 165 165 165 166 102 102 355 352 353 352 353 352 353 357 102 102 384 351 379 351 379 351 379 351 379 351 379 351 379 351 379 383 102 355 352 353 352 353 352 353 352 353 352 353 352 353 352 353 352 353 357 102 102 102 164 165 165 165 165 165 165 165 165 165 165 165 165 165 165 165 165 165 165 165 165 165 
165 165 165 165 165 165 165 166 102 102 380 381 381 381 381 381 381 382 102 102 102 102 102 102 102 102 102 102 102 102 102 102 102 102 102 102 102 380 381 381 381 381 381 381 381 381 381 381 381 381 381 381 381 381 382 102 102 102 189 240 165 165 165 165 165 165 165 165 165 165 165 165 165 165 165 165 165 165 165 165 
165 165 165 165 165 165 165 216 141 102 102 102 102 102 102 102 102 102 102 102 102 102 102 102 102 102 102 102 102 102 102 102 102 102 102 102 102 102 102 102 102 102 102 102 102 102 102 102 102 102 102 102 102 102 102 102 102 102 102 189 240 165 165 165 165 165 165 165 165 165 165 165 165 165 165 165 165 165 165 165 
165 165 165 165 165 165 165 165 216 141 102 102 102 102 102 102 102 102 102 102 102 102 102 102 102 102 102 102 102 102 102 102 102 139 140 140 140 140 140 141 102 102 102 102 102 102 102 102 102 102 102 102 102 102 102 385 386 102 102 102 164 165 165 165 165 165 165 165 165 165 165 165 165 165 165 165 165 165 165 165 
165 165 165 165 165 165 165 165 165 166 102 102 102 102 102 102 102 102 102 102 102 102 102 102 102 102 102 102 102 102 102 139 140 215 165 165 165 165 165 216 140 141 102 102 102 102 102 102 102 102 102 102 102 102 102 302 304 102 102 102 189 240 165 165 165 165 165 165 165 165 165 165 165 165 165 165 165 165 165 165 
165 165 165 165 165 165 165 165 165 216 141 102 102 102 102 102 102 102 102 102 102 102 102 102 102 102 102 102 102 102 139 215 165 165 165 165 165 165 165 165 165 216 140 141 102 102 102 102 102 102 102 102 102 102 102 376 378 102 102 102 102 189 190 240 165 165 165 165 165 165 165 165 165 165 165 165 165 165 165 165 
165 165 165 165 165 165 165 165 165 165 216 141 102 102 102 102 102 102 102 102 102 102 102 102 102 102 102 102 102 139 215 165 165 165 165 165 165 165 165 165 165 165 165 216 140 140 140 141 102 102 102 102 102 102 102 302 304 102 102 102 102 102 102 189 240 165 165 165 165 165 165 165 165 165 165 165 165 165 165 165 
165 165 165 165 165 165 165 165 165 165 165 216 141 102 102 102 102 102 102 102 102 102 102 102 102 102 102 139 140 215 165 165 165 165 165 165 165 165 165 165 165 165 165 165 165 165 165 216 140 141 102 102 102 102 102 376 378 102 102 102 102 102 102 102 189 240 165 165 165 165 165 165 165 165 165 165 165 165 165 165 
165 165 165 165 165 165 165 165 165 165 165 165 216 102 141 102 102 102 102 102 102 102 102 102 102 102 139 215 165 165 165 165 165 165 165 165 165 165 165 165 165 165 165 165 165 165 165 165 165 216 141 102 102 102 102 302 304 102 102 102 102 102 102 102 102 189 240 165 165 165 165 165 165 165 165 165 165 165 165 165 
165 165 165 165 165 165 165 165 165 165 165 165 165 165 216 140 140 140 140 140 140 140 140 140 140 140 215 165 165 165 165 165 165 165 165 165 165 165 165 165 165 165 165 165 165 165 165 165 165 165 216 141 102 102 102 376 378 102 102 102 102 102 102 102 102 102 164 165 165 165 165 165 165 165 165 165 165 165 165 165 
165 165 165 165 165 165 165 165 165 165 165 165 165 165 165 165 165 165 165 165 165 165 165 165 165 165 165 165 165 165 165 165 165 165 165 165 165 165 165 165 165 165 165 165 165 165 165 165 165 165 165 216 141 102 102 302 304 102 102 102 102 102 102 102 102 102 189 240 165 165 165 165 165 165 165 165 165 165 165 165 
165 165 165 165 165 165 165 165 165 165 165 165 165 165 165 165 165 165 165 165 165 165 165 165 165 165 165 165 165 165 165 165 165 165 165 165 165 165 165 165 165 165 165 165 165 165 165 165 165 165 165 165 216 141 102 360 361 102 102 102 102 102 102 102 102 102 102 164 165 165 165 165 165 165 165 165 165 165 165 165 
165 165 165 165 165 165 165 165 165 165 165 165 165 165 165 165 165 165 165 165 165 165 165 165 165 165 165 165 165 165 165 165 165 165 165 165 165 165 165 165 165 165 165 165 165 165 165 165 165 165 165 165 165 166 102 102 102 102 102 102 102 102 102 102 102 102 102 164 165 165 165 165 165 165 165 165 165 165 165 165 
165 165 165 165 165 165 165 165 165 165 165 165 165 165 165 165 165 165 165 165 165 165 165 165 165 165 165 165 165 165 165 165 165 165 165 165 165 165 165 165 165 165 165 165 165 165 165 165 165 165 165 165 165 166 102 330 331 331 331 331 331 331 332 102 102 102 102 164 165 165 165 165 165 165 165 165 165 165 165 165 
165 165 165 165 165 165 165 165 165 165 165 165 165 165 165 165 165 165 165 165 165 165 165 165 165 165 165 165 165 165 165 165 165 165 165 165 165 165 165 165 165 165 165 165 165 165 165 165 165 165 165 165 241 191 102 355 327 328 327 328 327 328 357 102 102 102 102 164 165 165 165 165 165 165 165 165 165 165 165 165 
165 165 165 165 165 165 165 165 165 165 165 165 165 165 165 165 165 165 165 165 165 165 165 165 165 165 165 165 165 165 165 165 165 165 165 165 165 165 165 165 165 165 165 165 165 165 165 165 165 165 165 241 191 102 102 355 352 353 352 353 352 353 357 102 102 102 102 164 165 165 165 165 165 165 165 165 165 165 165 165 
165 165 165 165 165 165 165 165 165 165 165 165 165 165 165 165 165 165 165 165 165 165 165 165 165 165 165 165 165 165 165 165 165 165 165 165 165 165 165 165 165 165 165 165 165 165 165 165 165 165 241 191 102 102 102 355 327 328 327 328 327 328 357 102 102 102 102 164 165 165 165 165 165 165 165 165 165 165 165 165 
165 165 165 165 165 165 165 165 165 165 165 165 165 165 165 165 165 165 165 165 165 165 165 165 165 165 165 165 165 165 165 165 165 165 165 165 165 165 165 165 165 165 165 165 165 165 165 165 241 190 191 102 102 102 102 355 352 353 352 353 352 353 357 102 102 102 102 164 165 165 165 165 165 165 165 165 165 165 165 165 
165 165 165 165 165 165 165 165 165 165 165 165 165 165 165 165 165 165 165 165 165 165 165 165 165 165 165 165 165 165 165 165 165 165 165 165 165 165 165 165 165 165 165 165 165 165 165 241 191 102 102 102 102 102 102 355 327 328 327 328 327 328 357 102 102 102 139 215 165 165 165 165 165 165 165 165 165 165 165 165 
165 165 165 165 165 165 165 165 165 165 165 165 165 165 165 165 165 165 165 165 165 165 165 165 165 165 165 165 165 165 165 165 165 165 165 165 165 165 165 165 165 165 165 165 241 190 190 191 102 102 102 102 102 102 102 355 352 353 352 353 352 353 357 102 102 102 164 165 165 165 165 165 165 165 165 165 165 165 165 165 
165 165 165 165 165 165 165 165 165 165 165 165 165 165 165 165 165 165 165 165 165 165 165 165 165 165 165 165 165 165 165 165 165 165 165 165 165 165 165 165 165 165 165 165 166 102 102 102 102 102 102 102 102 102 102 380 381 381 381 381 381 381 382 102 102 139 215 165 165 165 165 165 165 165 165 165 165 165 165 165 
165 165 165 165 165 165 165 165 165 165 165 165 165 165 165 165 165 165 165 165 165 165 165 165 165 165 165 165 165 165 165 165 165 165 165 165 165 165 165 165 165 165 165 165 166 102 102 102 102 102 102 102 102 102 102 102 102 102 102 102 102 102 102 102 139 215 165 165 165 165 165 165 165 165 165 165 165 165 165 165 
165 165 165 165 165 165 165 165 165 165 165 165 165 165 165 165 165 165 165 165 165 165 165 165 165 165 165 165 165 165 165 165 165 165 165 165 165 165 165 165 165 165 165 165 216 140 141 102 102 102 102 102 102 102 102 102 102 102 102 102 102 102 139 140 215 165 165 165 165 165 165 165 165 165 165 165 165 165 165 165 
165 165 165 165 165 165 165 165 165 165 165 165 165 165 165 165 165 165 165 165 165 165 165 165 165 165 165 165 165 165 165 165 165 165 165 165 165 165 165 165 165 165 165 165 165 165 216 140 140 141 102 102 102 102 102 102 102 102 102 102 102 139 215 165 165 165 165 165 165 165 165 165 165 165 165 165 165 165 165 165 
165 165 165 165 165 165 165 165 165 165 165 165 165 165 165 165 165 165 165 165 165 165 165 165 165 165 165 165 165 165 165 165 165 165 165 165 165 165 165 165 165 165 165 165 165 165 165 165 165 216 140 140 140 140 140 140 140 140 140 140 140 215 165 165 165 165 165 165 165 165 165 165 165 165 165 165 165 165 165 165 
165 165 165 165 165 165 165 165 165 165 165 165 165 165 165 165 165 165 165 165 165 165 165 165 165 165 165 165 165 165 165 165 165 165 165 165 165 165 165 165 165 165 165 165 165 165 165 165 165 165 165 165 165 165 165 165 165 165 165 165 165 165 165 165 165 165 165 165 165 165 165 165 165 165 165 165 165 165 165 165 
165 165 165 165 165 165 165 165 165 165 165 165 165 165 165 165 165 165 165 165 165 165 165 165 165 165 165 165 165 165 165 165 165 165 165 165 165 165 165 165 165 165 165 165 165 165 165 165 165 165 165 165 165 165 165 165 165 165 165 165 165 165 165 165 165 165 165 165 165 165 165 165 165 165 165 165 165 165 165 165 
165 165 165 165 165 165 165 165 165 165 165 165 165 165 165 165 165 165 165 165 165 165 165 165 165 165 165 165 165 165 165 165 165 165 165 165 165 165 165 165 165 165 165 165 165 165 165 165 165 165 165 165 165 165 165 165 165 165 165 165 165 165 165 165 165 165 165 165 165 165 165 165 165 165 165 165 165 165 165 165 
165 165 165 165 165 165 165 165 165 165 165 165 165 165 165 165 165 165 165 165 165 165 165 165 165 165 165 165 165 165 165 165 165 165 165 165 165 165 165 165 165 165 165 165 165 165 165 165 165 165 165 165 165 165 165 165 165 165 165 165 165 165 165 165 165 165 165 165 165 165 165 165 165 165 165 165 165 165 165 165 
165 165 165 165 165 165 165 165 165 165 165 165 165 165 165 165 165 165 165 165 165 165 165 165 165 165 165 165 165 165 165 165 165 165 165 165 165 165 165 165 165 165 165 165 165 165 165 165 165 165 165 165 165 165 165 165 165 165 165 165 165 165 165 165 165 165 165 165 165 165 165 165 165 165 165 165 165 165 165 165 
165 165 165 165 165 165 165 165 165 165 165 165 165 165 165 165 165 165 165 165 165 165 165 165 165 165 165 165 165 165 165 165 165 165 165 165 165 165 165 165 165 165 165 165 165 165 165 165 165 165 165 165 165 165 165 165 165 165 165 165 165 165 165 165 165 165 165 165 165 165 165 165 165 165 165 165 165 165 165 165 
165 165 165 165 165 165 165 165 165 165 165 165 165 165 165 165 165 165 165 165 165 165 165 165 165 165 165 165 165 165 165 165 165 165 165 165 165 165 165 165 165 165 165 165 165 165 165 165 165 165 165 165 165 165 165 165 165 165 165 165 165 165 165 165 165 165 165 165 165 165 165 165 165 165 165 165 165 165 165 165 
165 165 165 165 165 165 165 165 165 165 165 165 165 165 165 165 165 165 165 165 165 165 165 165 165 165 165 165 165 165 165 165 165 165 165 165 165 165 165 165 165 165 165 165 165 165 165 165 165 165 165 165 165 165 165 165 165 165 165 165 165 165 165 165 165 165 165 165 165 165 165 165 165 165 165 165 165 165 165 165 
165 165 165 165 165 165 165 165 165 165 165 165 165 165 165 165 165 165 165 165 165 165 165 165 165 165 165 165 165 165 165 165 165 165 165 165 165 165 165 165 165 165 165 165 165 165 165 165 165 165 165 165 165 165 165 165 165 165 165 165 165 165 165 165 165 165 165 165 165 165 165 165 165 165 165 165 165 165 165 165 
165 165 165 165 165 165 165 165 165 165 165 165 165 165 165 165 165 165 165 165 165 165 165 165 165 165 165 165 165 165 165 165 165 165 165 165 165 165 165 165 165 165 165 165 165 165 165 165 165 165 165 165 165 165 165 165 165 165 165 165 165 165 165 165 165 165 165 165 165 165 165 165 165 165 165 165 165 165 165 165 
165 165 165 165 165 165 165 165 165 165 165 165 165 165 165 165 165 165 165 165 165 165 165 165 165 165 165 165 165 165 165 165 165 165 165 165 165 165 165 165 165 165 165 165 165 165 165 165 165 165 165 165 165 165 165 165 165 165 165 165 165 165 165 165 165 165 165 165 165 165 165 165 165 165 165 165 165 165 165 165 
165 165 165 165 165 165 165 165 165 165 165 165 165 165 165 165 165 165 165 165 165 165 165 165 165 165 165 165 165 165 165 165 165 165 165 165 165 165 165 165 165 165 165 165 165 165 165 165 165 165 165 165 165 165 165 165 165 165 165 165 165 165 165 165 165 165 165 165 165 165 165 165 165 165 165 165 165 165 165 165 
165 165 165 165 165 165 165 165 165 165 165 165 165 165 165 165 165 165 165 165 165 165 165 165 165 165 165 165 165 165 165 165 165 165 165 165 165 165 165 165 165 165 165 165 165 165 165 165 165 165 165 165 165 165 165 165 165 165 165 165 165 165 165 165 165 165 165 165 165 165 165 165 165 165 165 165 165 165 165 165 
165 165 165 165 165 165 165 165 165 165 165 165 165 165 165 165 165 165 165 165 165 165 165 165 165 165 165 165 165 165 165 165 165 165 165 165 165 165 165 165 165 165 165 165 165 165 165 165 165 165 165 165 165 165 165 165 165 165 165 165 165 165 165 165 165 165 165 165 165 165 165 165 165 165 165 165 165 165 165 165
